اَنوشا	جاویدانبرگشتبهلیست
اِستاتیرا	همسرداریوشسوم
اِلِنا	هلنوهلنا
اِلسا	(ترکیـفارسی)(ال=ایل+سا(پسوندشباهت))مثلایل،همانندایل.
اِلسانا	مثلایل،مثلمردمایلوشهروولایت،چونخویشان
اِلینا	نیکوییونعمتبرایما
ابتسام	تبسم،لبخندزدن
ارنواز	نیکوسخنوخوشگفتار.نامیکیازخواهرانجمشید
اروس	سپید،درخشانوزیبا
ارون	شادوشادمان
اریکا	مرتبطبازمین
اسما	عربیجمعاسم،نامها،نامدخترابومسلمخراسانی
اسنا	بانویبزرگواروبلندمرتبه
اشک	آبیکهازچشممیریزد
اصیلا	بانویبااصالت
افرا	ستایشکردن
افشید	شکوهخورشید
الحان	نواهایخوش،نغمههایدلکش،صدایموزونوخوشآیند
المیرا	فداکننده
النا	یونانینورانی
الناز	ایلنازموجبنازشایل
الوا	ستاره
الیانا	یکیوهدیه
الیسا	دختریکهمانندگلانارلطیفاست
الیکا	مادرزمین–شکوفه–نامدهیدرشماایران
الین	همنژادوهمخون
امانه	اطمینانوآرامشقلب،دختریکهوجودشمایهقوتقلباست
امیرا	بانویحاکم
امینه	مؤنثامین
انار	میوهایخوراکیبادانههایقرمزیاسفیدفراوانومزهترشیاشیرین
انارام	روشناییبیفروغوبیپایان
انارگل	گلانار
انگبین	عسل
انوش	جاویدان
انیس	عربیهمدم
انیسه	عربیهمدم
اوران	درگویشسیستان
اورانوس	فرانسهنامهفتمینسیارهمنظومهشمسی
اورنینا	یونانیربهالنوعفراوانینعمت
اورینا	یونانیدراساطیریونان،الههآسمانهاوحامیعشقآسمانی
ایرانا	ایران+ا(پسوندنسبت)،منسوببهایران،مربوطبهایران،ایرانی
ایرسا	رنگینکمان
ایلماه	یعنیماهایل،ریشهیاسملری،لریبختیاری
آبنوش	اززنانویسورامین
آپامه	خوشرنگوآب؛دختراردشیردومهخامنشی
آترا	نامیکیازماههایپاییز
آترین	آذرینمانندآتش،زیباوپرانرژی
آتشگون	سرخفام،سرخرنگ
آتنا	دراساطیریونان،خدایاندیشه،هنر،دانشوصنعت
آتوسا	نامدخترکوروشپادشاههخامنشیوبهمعنیقدرتوتوانمندیاست.
آتیه	آینده
آدا	پاداشمینوی،فرشتهتوانگری
آدخت	خجستهونیکو
آدرینا	آتشین،سرخرو،دخترزیبارو،بانویآتشین
آدنا	نامروستاییدرنزدیکیچالوس
آذربانو	بانویآتشگون
آذرچهر	همانندروشنایی
آذرگون	گلهمیشهبهار
آذرمینا	لعلگون،سرخرنگ
آذین	زینت،زیور،نامیکیازفرماندهانسپاهبابکخرمدین،نامپهلوانیدرویسورامین
آذینگل	زینتگل،زیورگل–کنایهاززیباییبسیارزیاد
آذين	زيور،زيب،زينت،آرايش؛(درقديم)آيين،رسموقاعده.
آراسته	بانظموترتیب
آراگل	آرایندهگلها–زیباکنندهگلها
آرالیا	درختچههایزینتی
آرام	سکون،ثبات،آسایش،طمأنینه
آرامدخت	ازنامهایبرگزیده
آرامدل	ازنامهایبرگزیده
آرامش	آرمیدن
آرامیس	آرامش،راحتی
آرتادخت	وزیرخزانهداریاردوانچهارماشکانی
آرتیستون	دخترکورشبزرگ–زنداریوش
آرزو	(پهلوی)،خواهش،كام،مراد،چشمداشت،اميد،توقعوانتظار؛
آرشیدا	بانویدرخشانآریایی،بانویآراستهودرخشان
آرمیتا	آرمان،عشقپاک
آرمیتی	فروتنیوپاکیومحبت
آرمیدخت	ازنامهایبرگزیده
آرمیلا	اسمدختراندرایرانباستان(شاهدخت)
آرميتا	(اوستايي)پارسا،پاك،فروتن.
آریان	بانویبسیارمقدس–نامدخترمینوسپادشاهاساطیرییونان
آریانا	منسوببهآریا،آریایی،نامقدیمایران
آزادچهر	آزادهنژاد
آزاده	آزاد،اصيل؛(درقديم)نجيب،شريف،صالح؛(درقديم)ايراني؛(اَعلام)نامزنِ…
آزیتا	آزیتانامدخترانهیایرانیایاستبهمعنی«الههیآتش»
آژند	نامگلیاست
آسا	زیورمایهزیباییووقاروثباتوتمکینوآسودگی
آساره	نامدختربهزبانلریبختیاریبهمعنی
آسمان	فضایبالایسرکهآبیرنگبهنظرمیرسد،
آسیمن	نامیپهلویکههمانسیمینامروزیاست
آشتی	مهرودوستی،یکرنگی
آشنا	یار،دوست
آشوب	شور،انقلاب
آشیان	لانهوکاشانه
آفتاب	گرمی،روشنایی
آفرین	درودوسپاس
آگرین	کردیآتشین،بهرنگآتش
آلا	نعمتها،نیکیها
آلاله	نامگلیاست
آلکا	درگویشسمناننامامامزادهای
آلما	ترکیسیب،کنایهاززیبایی
آلیس	الیسیکاسمدخترانهباریشهفرانسویبهمعنیبانوینجیبزاده،دختراصیل،
آلیشان	هردوترکیشعلهور
آماندا	ایننامبهمعنایدوستداشتنیاست.
آمتیس	آمیتیس،نامدخترخشایارپادشاههخامنشی
آمی‌تیس	پادشاهماد،نامزنکورش
آناشید	دخترزیبارویمادر،مایهدلگرمیوروشناییزندگیمادر
آناهيتا	(اوستايي)بي‌آلايش،پاك،بهدورازآلودگيوناپاكي؛
آنجلا	آنجلاشکلدخترانهنامپسرانجلوساست.
آندیا	نامزناردشیرساسانی
آنسه	مانوس،همنشیننیکو
آنیتا	آراستگی،مهربانی،خوشرویی
آوا	نداوصدا،نغمه
آوین	کردیعشق
آوینا	عشق
آهنگ	سرودونغمه
آهو	غزال،غزاله؛(بهمجاز)معشوقزيبا؛(درقديم)(بهمجاز)چشمزيبا؛
آیدا	شاد،خوش
آیسان	آی(ترکی)+سان(فارسی)زیبا،مانندماه
آینور	اسمترکیبیترکی_عربیبهمعنینورماه،نورانیمثلماه،روشناییماه،
آیه	نشانه،نشانهخدا
آيدا	(تركي)گياهيكهكنارآبمي‌رويد؛شاد،ماه–نامتذکمنب
آيه	(عربي)نشانه،نشان‌،معجزه،دليل،حجت،برهان؛اعجوبه،عجيبه

بانو	خانم،کلمهاحترامدربارهبانوانبرگشتبهلیست
بَرفین	برفی،ازجنسبرف؛سفیدمانندبرف؛(بهمجاز)زیباچهره
بَصیرا	منسوببهبصیر؛منتسببهدانایی؛(بهمجاز)دختریکهبیناوداناباشد.
بُشرا	بشارت،مژده،مژدگانی؛ازواژههایقرآنی
بِه‌آفرین	خوبآفریده؛خوشسیما،خوشمنظر
بِهشید	تابناکودارایفروغوروشنایی
باختر	مغرب؛بهمعنیستارهاست.
بادامک	بادامکوچک،نوعیدرختبادام
باران	قطره‌هایآبکهبراثرمایعشدنبخارآبِموجوددرجوزمینایجادمی‌شود
بارلی	بار(فارسی)+لی(ترکی)میوهدار،سودمند
بارنک	نامدرختیاست.
باستیان	بردبار،شکیبا
بافرین	بآفرین،لایقتحسینوتشویق،درخورآفرین
بالنده	آنکهیاآنچهدرحالرشدیاترقیوپیشرفتاست.
بالیده	رشدونموکرده
بامک	بامداد،صبح
بامی	درخشان،لقبشهربلخ
بامین	نامروستاییدرنزدیکیهرات
بانوگشسب	نامدختررستمزال،زنگیوومادربیژن
باور	مجموعهاعتقادهاییکهدریکجامعهموردپذیرشقرارگرفتهاست،
بختآفرید	آفریدهبختواقبال
بخشایش	گذشتوچشمپوشیکردنگناهیاکارنادرستکسی،عفو،رأفت،رحمتوشفقت.
بخشنده	آنکهچیزیرابیآنکهعوضیبخواهدمیبخشد؛عطاکننده.
بردبار	شکیبا،باحوصله
برزآفرید	آفریدهباشکوه،ناممادرفرود
برسومه	برسم،شاخه‌هایگیاه
برشید	بر(میوه)+شید(خورشید)،میوهخورشید
برفین	برفی،ازجنسبرف؛سفیدمانندبرف؛(بهمجاز)زیباچهره.
برگ	بهضمب،ابرو
برنا	جوان،خوشاندام
برومند	(اسمدختروپسر)خوشقامت،ناممادربابکخرمدین
برهون	هاله،خرمنماه
بلوت	درختسودبخش
بلوط	گیاهیدرختیوجنگلیکهمیوهآنخوراکیاست.
بمانی	نامیکهباآنطولعمرکودکرابخواهند.
بنفشه	نامگل،(بهمجاز)مو،زلف؛
بنیتا	دختربیهمتایمن
بوته	گیاه،ساقهجوان
بوختار	ازنامهایبرگزیده
بوژنه	شکوفه،غنچهاسمدختر
بوستان	بستان،باغوگلزار
بویه	آرزو
بهآفرید	نامدخترکیگشتاسب
بهنگار	خوبچهره،نیکوصورت
بهار	فصلاولسال
بهارا،بهار،بهاران	فصلبهار
بهاران	هنگامبهار،موسمبهار؛(بهمجاز)زیباوباطراوت.
بهارآفرین	آفرینندهبهار
بهاردخت	دختربهار
بهارک	بهمعنایمانندبهار،همچونبهار؛(بهمجاز)زیباباطراوت
بهارگل	گلیکهدربهارمیروید.
بهارناز	موجبفخرونازشبهار
بهاره	مربوطبهبهار؛بهعملآمدهدربهار؛منسوببهبهار.
بهارین	منسوببهبهار،بهاری
به‌آفرید	نامدخترگشتاسپپادشاهکیانیوخواهراسفندیار
به‌آفرین	نیکآفریدهشده
به‌آیین	دارایآیینبهتر
بهدخت	نیکتریندوشیزه
بهدیس	مانندبه(بهمیوهایخوشعطروبو)
بهرخ	نیکچهره
بهرو	نیکوچهره
بهشت	پردیس،بهترین
بهکامه	مرکبازبه(بهتر،خوبتر)+کامه(آرزو)
بهگل	نیکوترینگل
بهناز	ازنامهایبرگزیده
بهنوش	نیکوتریننوشیدنی
بهین	بهترین،نیکوترین
بیتا	بیمانند،بیهمتا،یکتا
بیدار	هشیاروسرزنده
بینا	روشن،دلآگاه
پَرَند	پروین،حریرساده؛گروهیازگیاهانبرگشتبهلیست
پَرَندیس	(پَرَن+دیس(پسوندشباهت))،شبیهبهپَرَنپَرَن،زیبارو،نرمولطیفچونپرند
پَرَنسا	همانندابریشمودیبا؛زیباولطیف
پَرتو	شعاعیکهازمنبعنورانییاگرماساطعمیشود،درخشش،تلألؤ،روشنایی؛اثر،تأثیر
پَردیس	بهشت؛فضایسبزوگلکاریشدهیاطرافساختمان.
پَرنیان	پارچهایابریشمیداراینقشونگار؛پردهینقاشی
پاداش	پاداش
پادمیرا	جاویدان،نگهبانمهر،نگهدارندهعشق
پادنا	اسمیکیازبخش‌هایتابعهشهرستانسمیرم،
پادینا	درگویشهمدانیبهگلپونهیاپودینهگفتهمی‌شود.
پارامیدا	پارامیس،نامدختربردیاونوهکوروشپادشاههخامنشی،
پاردیس	پردیس
پارلا	(ترکی)بهمعنیدرخشندهونورانی–درخشندهونورانی
پارمیدا	پارامیدا،پارامیس،پرمیس
پارمیس	پرمیس،نامدختربردیاونوهکوروشبزرگپادشاههخامنشی
پارمین	تکهیاقطعه‌ایازبلور؛نامزنِداریوش.
پارنا	نامقله‌ایدرنزدیکیپلدختر
پارند	نیکبختیوفرارونی؛نگهبانگنجوخواسته
پاشنگ	خوشه‌یانگور
پاکسیما	ازنامهایبرگزیده
پاکبانو	آناهیتا،بانویپاک
پاکچهر	خوشصورت
پاکدخت	دخترپاکوعفیف
پاکدل	پاکیزهدل،دلپاک،خوشقلب
پاکرخ	پاکیزهرو،زیبارو
پاکروز	ازنامهایبرگزیده
پاکروی	پاکیزهروی،زیباروی
پاک‌سیما	دارایصورتیپاکوزیبا
پاکفر	ازنامهایبرگزیده
پاکناز	داراینازخوش
پاکنوش	پاکنوشنده
پالیز	باغ
پامچال	گلیزینتیبهرنگهایسفید،صورتی،یانارنجی
پانته‌آ	پایدار،نگهباننیرومند،نامهمسرآبرداتاسکهدرزمانکوروش،پادشاهشوشبود
پانتی	نامهمسرآریاسبازسردارانکوروشپادشاههخامنشی
پانیا	محافظنگهدارنده
پانیذ	پانید،قندمکرر،شکر،شکربرگ،
پانیک	کسیکهقدمشنیکاست،خوشقدم
پایون	پیرایه،زیور،آرایش
پاییز	هنگامپاییز،برگریزان،مجازادخترزیبارو
پاییزان	هنگامپاییز
پدیده	پدیدار؛شخص،چیزیاحادثه‌یچشمگیر.
پرتو	فروغ،روشنایی
پرخیده	سخنسربسته
پردیس	باغبهشت
پرسا	نرمولطیفمانندپر.
پرستش	نیایش،عبادت
پرستو	پرنده‌ایسیاهوسفیدبابالهایباریککهمهاجراست.
پرستوک	پرستو،ناماصیلپارسی
پرسون	برهونهاله،خرمنماه
پرشت	پرآرزو
پرگل	(بهفتحپ)هریکازگلبرگهایگل
پرمون	زینتوآرایش
پرند	پارچهابریشمی
پرنیان	حریر،دیبا
پروا	ملاحظه،فرصتوزمانپرداختنبهکاری،فراغتوآسایش،توجه
پروانه	ازنامهایبرگزیده
پروین	نامستاره‌ای
پری	زنزیبا
پریبانو	ازنامهایبرگزیده
پریسیما	زیباروی
پریچهر	فرشتهرو،زیبامثلپری؛زیبارو
پریدخت	ازنامهایبرگزیده
پریرخ	پریرو،پریرخسار،خوبروی
پریروی	خوشگل،زیبارو
پریزاد	فرزندپری،فرزندزیبا
پریسا	مانندپری
پریسان	ازنامهایبرگزیده
پریفام	زیباچهره
پریگون	مانندپری
پریماه	زیباچونماهوپری
پریمرز	ازنامهایبرگزیده
پریناز	ازنامهایبرگزیده
پریوش	پریمانند
پگاه	سحر،بامداد
پوپک	هدهد
پودینه	پونه
پوران	ازنامهایبرگزیده
پوروچیستا	نامکوچکتریندختراشوزرتشت
پونه	بوتهوگلیخوشبو
پیچک	گیاهیزینتیکهساقهایبالاروندهدارد.
پیراسته	بانظم،باآرایش
پیرایه	آراسته،آرایش
پیروزه	ازسنگهایقیمتی
پینار	بهچشمه،سرچشمه

تَرَنُم	آوازخوشبرگشتبهلیست
تَرلان	مرغیازجنسبازشکاریراگویند؛(درکردی)بهزیبا؛نامنوعیاسباست.
تَرنّم	خواندنشعر،ترانه،ومانندآنها
تَندُر	بلبل
تَندیس	مجسمه؛بت،تصویربرجسته،تمثال؛(بهمجاز)زیباروی.
تُرنج	ناممیوهایاست
تِلما	گندمگون
تِهرت	نامدخترمیانهاشوزرتشت
تِیتَک	شبکیهچشمبهزبانپهلوی
تابا	طاقت،پیچوتابزلف،فروغ،تابنده،تابان
تابان	داراینوروروشنی،درخشان،روشن
تابانمهر	ازنامهایبرگزیده
تابش	نورافشان
تابناک	پرتو،نورانی
تابناک	جذاب،روشنودرخشنده
تابنده	آنچهمی‌تابدونورافشانیمی‌کند،درخشان.
تاتیانا	تاتینا،پرندهشکاری
تاتین	پرنده‌ایشکاری
تاجآفرین	آفرینندهتاج،بهوجودآورندهتاج
تاجبانو	ملکه،شاهزادهخانم
تاجخاتون	ملکه،شاهزادهخانم
تاجدخت	تاج(کلاهپادشاهی،افسر)+دخت(دختر)
تاجگل	آنکهچونتاجیدررأسگلهااست،زیبا
تاجماه	آنکهچونتاجیبرسرماهاست،بسیارزیبا
تاجمهر	آنکهچونتاجیبرسرخورشیداست،یادستهگلیبهشکلتاج،بسیارزیبا
تارا	ستارهکوکبمردمکچشم
تارادخت	دخترستاره،دخترچونستاره،(بهمجاز)دخترزیبا،صاحبحسنوکمال
تارادیس	مانندستاره
تازه	جدید،پرتراوت،لطیف
تاژ	لطیف،نازک،نامپسرفرواکبرادرهوشنگپادشاهپیشدادی
تافته	گداخته،درخشندهوتابناک،روشن،نوعیپارچهابریشمی
تاکآفرین	مرکبازتاک(درختانگور)+آفرین(آفریننده)
تاکدخت	مرکبازتاک(درختانگور)+دخت(دختر)
تالین	پایتختکشوراستونی،برکناره‌یجنوبیخلیجفنلاندازبندرهایعمده‌یدریایبالتیک.
تامیلا	ازرویامیدواری،امیدوارانه؛دربرخیمنابعبهبخشنده
تانسو	زلالیچشمه،تمیزیوپاکیوزیبایی
تانیا	درفارسیبهمعنیدختریگانهوبیمانند
تبسّم	لبخند،خندهیبدونصدا؛(بهمجاز)درخشیدن
تخشک	خوبرووزیبا
تذرو	نامدخترداریوشسومهخامنشی
ترانه	قطعهآوازی،هرصداییکهحالتموسیقاییداشتهباشد.
ترگل	گلتازهوشاداب
ترلان	زیبا؛نامنوعیاسباست.
ترمه	نوعیپارچه(قیمتی)ازجنسکرک،پشم،یاابریشم
ترنج	بالنگ؛طرحیمرکّبازطرح‌هایاسلیمی
ترنگ	آوازتارهایساز
ترنیان	سبدیکهازشاخههایبیدمی‌بافند
تروند	میوهتازهرسیده،نوبر
تریتی	نامدخترمیانهاشوزرتشت
تسنیم	رودیدربهشت(سورهمطففین)
تشتر	نامستارهتیر.نگهبانباران
تکاو	نامیکیازآهنگهاینامیباربد
تکتم	نامچاهزمزم،ناممادرامامرضا،بانویرازدارورازنگهدار
تلّی	دختریکهگیسویبلندوزیبادارد،زلفدار؛زبانداروسخنور.
تمنا	خواهش،درخواست،آرزو
تمیس	گیاهیبالارونده
تناز	ناممادرلهراسب.دخترآرش
تنبور	نوعیساز،دنبره
تندیس	پیکره،تصویر
توار	پرنده,نامکوهیدرشمالایران،شهرستانچالوس
توتیا	ازآبزیاندریاییکهدربستردریازندگیمیکند؛گردیکهبهعنوانسُرمهاستفادهمیکنند.
توران	ازنامهایبرگزیده
تورانبانو	ازنامهایبرگزیده
توراندخت	ازنامهایبرگزیده
توسکا	توسا،درختیبلندوجنگلیکهدرمناطقمرطوبوکنارآبهامی‌روید.
توکا	پرنده‌ایازخانوادهگنجشکبامنقاریباریکوتنیرنگارنگ
تهمینه	زنرستمومادرسهراب
تیارا	تیهدرگویشلریبهمعنایچشموآرابهمعنایآرایندهمیباشد،چشمآرا،زیبا
تیسا	درگویشمازندرانخالص
تینا	درعربی(طین)بهمعنیگِلسرخ
تیهو	پرنده‌ایخوشرنگ

ثَمینا	(ثمین+الفنسبت)منسوببهثمین،ثمینبرگشتبهلیست
ثریا	(عربی)پروین(نامستارهایدرمنظومهشمسی)
ثمر	میوه؛(بهمجاز)نتیجهوحاصل
ثمره	میوه؛(بهمجاز)نتیجهوحاصل
ثمن	بها،قیمت
ثمین	(عربی)گرانبها،ارزشمند،قدیمی
ثمین	گرانبها،قیمتی،گران
ثمینا	گرانبهاوارزشمند(ترکیبیعربی-فارسی)
ثمینه	گرانبها،قیمتی،گران
ثنا	ستایشخداوند،حمدخداوند،شکر،دعا

جَمیله	مؤنثجمیل،جمیل؛زیبابرگشتبهلیست
جُمانه	یکدانهمروارید،یکدانهلؤلؤ؛نامدخترابوطالبوخواهرحضرتعلی(ع)
جالیز	کشتزار
جام	پیاله،ساغر
جانافروز	(بهمجاز)آسایشبخشروان
جانبانو	بانوییکهچونجانعزیزاست.
جانپرور	ازنامهایبرگزیده
جاننواز	آرامشدهندهجان،محبوب
جانا	ایجان،ایعزیز
جانان	معشوق،محبوب؛خوب
جانانه	محبوب،معشوق،(درتصوف)(بهمجاز)خداوند
جاندخت	محبوبه،معشوقه،دختریکهچونجانعزیزاست.
جانمهر	ازنامهایبرگزیده
جلبک	گیاهسبزآبزی
جلگه	زمینپهناور
جلوه	نمایانشدن،خودراآشکارکردن،خودنمایی؛(بهمجاز)زیبایی،جاذبه
جلیله	مؤنثجلیل
جمانه	یکدانهمروارید،یکدانهلؤلؤ؛نامدخترابوطالبوخواهرحضرتعلی(ع)
جمدخت	جم(پادشاهبزرگ)+دخت(دختر)
جنان	بهشت؛باغها
جنت	بهشت،فردوس
جوانه	تازه،نو؛جوان
جوانه	جوان،جوانی،رویش
جواهر	هریکازسنگهایگرانبهامانندیاقوتوزمرد؛
جویبار	کنارجویآب
جهانآوا	مرکبازجهان(عالم،گیتی)+آوا(صدا،بانگ)
جهانبانو	بانویجهانیان
جهانخاتون	خاتونجهانیان،بانویجهانیان،شاعرهایرانیدرقرنهشتم
جهانماه	آنکهدرجهانچونماهمیدرخشد،زیبا
جهانناز	مایهافتخارجهان،فخرجهان
جهانتاب	آنچهبهجهاننوروروشناییمیدهد،عالمتاب،نوردهندهجهان
جهاندخت	دخترشهرهدرعالم
جهانرخ	مرکبازجهان(عالم،گیتی)+رخ(چهره،صورت)
جیحون	رودبزرگ،رود،نامرودیدرآسیایمیانه
جیران	آهو(بهمجاز)معشوقِزیبا؛چشمِزیبا

چَمان	خرامانبرگشتبهلیست
چام	نازوعشوه
چامه	شعر،شعریکهباآوازخواندهمی‌شود.
چرمه	اسببهویژهاسبسفیدرنگ
چشمه	مکانیکهآبزیرزمینیدرآنجابهطورطبیعیدرسطحزمینظاهرمی‌شود.
چکامه	شعربهویژهقصیده.
چکاو	نامپرندهایخوشآواز
چکاوک	پرنده‌ایخوشآوازوکمیبزرگ‌ترازگنجشککهتاجبرسردارد.
چکاوه	چکاوک
چلچله	پرستو
چمان	آنکهمی‌خرامدوبانازحرکتمی‌کند،خرامان،رونده،راهوار،
چمانه	پیالهشراب
چمن	زمینسبزوخرم،باغوبوستانمرغزار؛نامگیاهیازتیره‌یغلات.
چمنافروز	آنکهیاآنچهزینتدهندهچمناست،تاجخروس
چمنآرا	زینتدهندهباغ،باغبان،آنچهموجبزیباییوآراستگیباغوبوستاناست.
چمنچهر	آنکهچهره‌ایزیباچونباغوبوستاندارد.
چمنناز	زیباروییکهداراینازوعشوهوکرشمهاست.
چنور	گیاهیخوشبوشبیهبهشوید،کهدربعضیازمناطقکردستانمی‌روید.
چوک	چشمه
چهرآذر	آذرچهر،دارایچهره‌ایچونآتش
چهرآرا	آرایندهچهره
چهرزاد	نژادواصیل،لقبهما،دختربهمندرشاهنامه
چهرمینو	آنکهچهره‌ایزیباچونبهشتدارد.
چهره	روی،صورت
چهرهگل	آنکهچهره‌ایزیباچونگلدارد.
چیترا	ازنامهایبرگزیده
چیستا	نامفرشتهدانشومعرفت
چیستی	دانشوآگاهی
چیکا	نوعیپرنده(ریشهگیلکی)
چیلانه	درختعناب

حَلیا	زیوروآرایشبرگشتبهلیست
حِلما	جمعحَلیم،بردباران،صبوران
حاتمه	مؤنثحاتمبهمعنیحاکم،قاضی،داور
حارثه	مؤنثحارث،زنکشاورز
حاصل	نتیجه
حامده	مؤنثحامد،سپاسگزار
حانی	(دخترانهوپسرانه)میشیاگاووحشی
حانیه	مهربان،دلسوز
حبه	دانه‌یبعضیازمیوه‌هاوگیاهان
حبیبه	مؤنثحبیب،دوست،یار،معشوقه
حدیث	عشق،سودا
حدیثه	نووتازه
حدیقه	باغ
حرمت	احترام
حره	دخترآزاده،ازاسامیحضرتزهرا،ازالقاببانواناشرافی
حریر	ابریشم
حریه	حُره
حسِیبا	دارایاصلونسب،پاکنژاد،پاکزادواصیل
حسْنا	زیبا،زنزیبا
حسانه	زنبسیارنیکو
حسنا	نیک،پسندیده
حسنه	خوب،نیک،پسندیده
حسنی	نیکو،پسندیده
حسنیه	نیکوتر،کارنیک،عاقبتنیکو
حسیبا	مرکبازحسیببهمعنایپاکنژادوپاکزادوالفنسبت،دختربااصلونسب
حسیبه	دارنده‌یناموشرفوبزرگی
حفصه	اسد،شیر؛
حفیظه	موکّلبهچیزی؛حافظومحفوظ
حکیمه	مؤنثحکیم،زنحکیمودانشمند
حلما	جمعحَلیم،بردباران،صبوران.
حلیا	آنچهدرچشمخوشمیدرخشد(حلی+ا)
حلیمه	مؤنثحلیم،زنخویشتندار،صبوروباتحمل،دختربردبار
حلیه	زینت،پیرایه،زیور؛مشخصاتصورتواندام
حماسه	کاریافتخارآفرین،نوعیشعر،دلیری،شجاعت،بیباکی
حمده	سپاسوشکرگزاری
حمرا	سرخرنگ
حمیده	مؤنثحمید،ستوده،پسندیده؛مادرامامموسیکاظم(ع).
حمیرا	مصغّرحمرا،زنسرخوسپید،زنسرخ
حنّان	آرزومند،مشتاق؛بخشاینده
حنّانه	بسیارنوحهکننده،نالهکننده
حنا	گیاهیدرختیکهگلهایسفیدومعطردارد،گردبسیارنرمسبزرنگیازگیاهیبههمیننام.
حنان	بسیارمهربان،یکیازنامهایخداوند،دردعایجوشنکبیرمیتونیدببینید
حنانه	ﻣﻬﺮﺑﺎﻥ،ﺑﺨﺸﺎﯾﻨﺪﻩ،ﺑﺴﯿﺎرﻧﺎﻟﻪﮐﻨﻨﺪﻩ
حنظله	مفردحَنظل
حنیسه	زنشجاع
حنیفا	حق،راست(لقبادیانتوحیدیومسلکحضرتابراهیم)
حنیفه	حق،راست(لقبادیانتوحیدیومسلکحضرتابراهیم)
حنیفه	مؤنثحنیف،دختردرستوپاک
حوا	نخستینزنیکهخداآفرید،همسرحضرتآدم(ع)
حور	زنزیبایبهشتی
حورا	حور،زنزیبایبهشتی؛زنِسفیدپوستِسیاهچشموموی.ریشه
حورالعین	زنیازنانسفیدپوستدرشتچشم
حورآسا	آنکهچونحورزیباست.
حورآفرین	مرکبازحور(زنزیبایبهشتی)+آفرین(آفریننده)
حورجهان	آنکهچهره‌ایزیباچونحوردارد.
حوردیس	آنکهچونحورزیباست.
حوررخ	حور,آنکهچهره‌ایزیباچونحوردارد.
حورزاد	زادهحور،زیبا
حوروش	دختریچونزن(زنان)زیبایبهشتی.
حوری	حور؛زنزیبا
حوریبانو	حور,زنزیبایبهشتی
حوریدخت	حور,مرکبازحوری(زنزیبایبهشتی)+دخت
حوریرخ	حور,آنکهچهره‌ایزیباچونحوریدارد.
حوریزاد	حور,زادهحوری،زیبا
حوریلقا	آنکهچونحوریزیباست.
حوریا	ازحوریبهمعنیفرشتهبهشتیمی‌آید،آنکهچونحورزیباست.
حوریه	زنسفیدپوستوزیباروی.
حیات	زندگی،زیست
حیفا	نامبندریدرفلسطین

خرمن	تودهغلهدروشده،تودهومقدارانبوهازهرچیزبرگشتبهلیست
خَضرا	(مؤنثاخضر)بهمعنیسبز،کبود،نیلگون،وآبیوسبز؛سبزه‌زار،چمن‌زار.
خَلف	فرزندصالح،شایسته؛جانشین؛(بهمجاز)پیرویکنندهازپدردراخلاقوکردار
خُتن	نامشهریدرترکستانشرقی،(بهمجاز)زیباروی.
خُرّم	سرسبزوباطراوت؛شاد،خوشحال،خوب،خوش؛فرخنده،مبارک.
خُوروَش	همانندخورشید
خاتَم	فرمان،حکموپایان؛نامشهرستانیدرجنوباستانیزد.
خاتون	لقبزناناشرافی،لقبهمسرخاقانچینکهانوشیرواندختراورابههمسریبرگزید
خاتونک	خاتون(بانو)+ک،بانویکوچک،نامروستاییدرنزدیکیشیراز
خارا	نوعیسنگآذرین،نامیکیازگوشه‌هایموسیقیایرانی
خارک	نوعیخرمایزردوخشک
خاطِره	یادبود،یاد،ذهن،حافظه،خاطر.
خاطرافروز	خاطر(عربی)+افروز(فارسی)شادیبخش
خاطرآسا	خاطر(عربی)+آسا(فارسی)آسایشدهندهخاطر
خاطرنواز	خاطر(عربی)+نواز(فارسی)دلکش،مطبوع
خالِده	مؤنثخالد
خانمگل	خانم(ترکی)+گل(فارسی)خانمیکهاززیباییولطافتچونگلاست.
خاور	(مخففِخاوران)همبهمعنیمشرقوهمبهمعنایمغرباست.
ختا	نامسرزمینچینشمالیکهمحلزندگیقبایلترکبودهاست.
ختمی	گیاهیعلفی،پایا،وزینتیازخانوادهپنیرککهگلهایدرشتدارد.
خجسته	شادباش،مبارک
خجستهلقا	خجسته(فارسی)+لقا(عربی)خوشسیما،خوشرو
خجیر	زیبارویوپسندیده
خداآفرید	آفریدهخداوند
خدیجه	مولودِپیشازاتمامماهها
خرامان	دارایحالتخرامیدن،درحالخرامیدن،بهآهستگیوباناز.
خرشا	خورشید،آفتاب،ازشخصیتهایشاهنامه،نامپسرخرادازسرداران‏خسروپرویزپادشاهساسانی.
خرشید	خورشید،آفتاب،ازشخصیتهایشاهنامه،نامپسرخرادازسرداران‏خسروپرویزپادشاهساسانی
خرمبانو	بانویشادوخوشحال
خرمبهار	آنکهچونبهارخرموباطراوتاست،نامدخترفتحعلیشاهقاجار
خرمچهر	آنکهچهرهایشادابوباطراوتدارد.
خرمگل	آنکهچونگلخرموباطراوتاست.
خرمدخت	دخترشادوباطراوت
خرمدل	خوشدل،خوشحال،شادمان
خرمناز	زیباوباطراوت
خرمه	نامهمسرمزدک،گیاهیاستمانندلوبیا
خزال	بانازراهرونده،کسیکهبانازراهمی‌رود.
خزان	نامسومینفصلسال،پسازتابستانوپیشاززمستان،پاییز
خزان	نامسومینفصلسال،پسازتابستانوپیشاززمستان،پاییز
خزر	فتان–دخترکهعشوههاییزیرکانهمیریزد
خضرا	سبز،تازه
خلیله	مؤنثخلیل
خندان	خندیدن،بالبخند
خندانچهر	آنکهچهرهایخندانومتبسمدارد.
خندانگل	آنکهچونگلشادابوباطراوتاست.
خوبچهر	دارایسیمایزیبا،زیبا.
خوبرخ	ازنامهایبرگزیده
خوبروی	ازنامهایبرگزیده
خوبیار	یارخوب
خوردخت	ازنامهایبرگزیده
خوردیس	مانندخورشید،درخشان
خورزاد	ازنامهایبرگزیده
خورسان	مانندخورشید
خورشاد	ازنامهایبرگزیده
خورشید	هور،هورشید
خورشیدچهر	ازنامهایبرگزیده
خورشیددخت	مرکبازخورشید+دخت(دختر)
خورشیدرخ	آنکهچهره‌اشچونخورشیدمی‌درخشد.
خورشیدفر	آنکهشکوهوجلالیچونخورشیددارد.
خورشیدمهر	آنکهمهرومحبتیچونخورشیددارد.
خوروش	خورشیدوش،تابانودرخشانچونخورشید
خوشلقا	خوش(فارسی)+لقا(عربی)خوشصورت،زیبا
خوشاب	میوه‌ایکهبامحلولآبوشکرمی‌پزند،روشنوشفاف،آبداروتروتازه،جواهرتابانودرخشان
خوشبوی	ازنامهایبرگزیده
خوشچهر	نیکوروی
خوشخو	نیکرفتار،باصفا
خوشدل	شاد،شادمان،خوشنود،خوشحال
خوشروز	دارایزندگیراحتوبارفاه.
خوشروی	خوشرو،خوشصورت،خوشگل
خوشگو	خوشسخن
خوشنوا	خوشآواز،خوشآهنگ
خوشه	تعدادیدانه،میوهیاگلکهبهمحورمتصلباشند
خوشیار	دوستویارشادوشادمان
خوشین	خوشوزیبا
خیرالنسا	بهترینِزنان؛عنوانیبرایحضرتفاطمه(س)دخترپیامبراسلام(ص)
خیزران	نوعینیمغزدارباساقهایمحکموبلند؛ناممادراماممحمّدتقی(ع)

دَستنبو	میوهایخوشبوبرگشتبهلیست
دَریا	(درجغرافیا)تودهیبسیاربزرگیازآب،دریاچه،(بهمجاز)شخصبسیارآگاهودانشمند،
دُخمل	ازنامهایبرگزیده
دُرافشان	روشن،تابان،شیرینسخن
دُردانه	دانهدر،مرواریدبزرگ
دُرسا	دُر=مروارید،لؤلؤ+سا(پسوندشباهت)،شبیهبهدُر؛(بهمجاز)گرانقیمتوارزشمند.
دُرنا	پرندهیآبچرِبزرگ،وحشیوحلالگوشت،کُلنگ.
دُرنا	نامپرندهایاست
دُرین	دُر+ین(پسوندنسبت)،ازدُر،ساختهشدهازدُر؛(بهمجاز)گرانبهاوقیمتی
دُغدو	ناممادراشوزرتشت
دِرمنَه	گیاهیخوشبو
دِنا	قسمتیازکوهستانشمالغربیفارسکهقلهایمعروفبههمیننامدارد
دادآفرید	ازدادآفریدهشده،ازنامهایخداوند
دادلی	شیرینونمکین
دارانا	نامروستاییدرنزدیکیاهر
دارینا	زرگر،طلاساز،مجازاارزشمندوگرانبها
دارینه	نامروستاییدرنزدیکیسقز
دالیا	نوعیازگلِکوکب
دامینه	زیبا،جاریوروان،همچنینبهمعنایدانشودانایینیزآمدهاست.
دایانا	(دایا(زرسرخوطلا)+پسونداسمسازِ(نا))بهمعنیمثلزرسرخو(بهمجاز)زیباروی
دراج	نامپرنده‌ایاست
درافشان	آنکهمرواریدمیافشاند؛(بهمجاز)بخشنده؛دارایفصاحتوزیبایی،بارانریز.
دربها	بانویارزشمند،دختریکهمانندمرواریدارزشمنداست،نامهمسرکورشکبیر
درتا	مانندمروارید،همتایدُر
درخشا	نورانی،تابنده،درخشان
درخشان	دارایدرخشش،روشنوتابان،درخشنده،(بهمجاز)جالبتوجهوچشمگیروخوبوموفقیتآمیز.
درخشنده	(صفتفاعلیازدرخشیدن)،دارایدرخششوتلألؤ؛روشنوتابان.
دردانه	بسیارمحبوبوگرامی،عزیزکرده،نازپرورده؛نیزفرزندبسیارگرامی.
درسا	دُر=مروارید،لؤلؤ+سا(پسوندشباهت)،شبیهبهدُر؛(بهمجاز)گرانقیمتوارزشمند.
درستی	پاکی،حقیقت،صحت،نامدخترانوشیروانپادشاهساسانی
درفام	ماننددردرآسادُرمانندبهرنگدُر
درفشان	درخشانوروشن
درمان	چاره
درناز	(دُر=مروارید،لؤلؤ+ناز=زیباوقشنگ)(بهمجاز)زیبارووگرانبها.
دریا	بحر
دریادخت	مرکبازدریا+دخت(دختر)
دریاناز	مرکبازدریاوناز،مایهنازومباهاتدریایابهمعنایدریایناز،
دلافروز	روشنکنندهدل
دلانگیز	نشاطآور
دلآرا	موجبآرامشوشادیدیگران؛محبوب،معشوق،
دلآرام	موجبآرامشوآسایشخاطر
دلآسا	موجبتسکینوآسایشدل
دلآشوب	ازنامهایبرگزیده
دلآویز	زیبا،دلنشین،محبوب
دلارام	موجبآرامشخاطر،محبوب،معشوق،باآسودگیخاطر.
دلاویز	دلپسند،مرغوب،دلخواه
دل‌آرا	موجبآرامشوشادیدیگران؛محبوب،معشوق،نامهمسردارا(داریوشسوم)
دلبر	یارومعشوق
دلپذیر	دلخواه,پسندیده
دلپسند	پسندیده،مرغوب
دلجو	نوازشکننده
دلخوش	خوشدل،خوشحال،شادمان
دلدار	دلبر,معشوق,دلیر,دلاور,شجاع
دلربای	زیبا،جذاب
دلشاد	خوشحال،شادمان
دلکش	دلربا,دلپذیر,دلفریب
دلگرم	خشنود،امیدوار
دلناز	موجبفخرومباهاتدل
دلنواز	مایهیآرامشدل،آرامشبخش؛نوازشگر،مهربانودلسوز،محبوبومعشوق.
دلوین	ربایندهدلوعشق
دمساز	همدم،همراز،همصحبت
دنبره	نوعیساز،تنبور
دنیز	اسمترکیبهمعنایدریا
دیبا	نوعیپارچهیابریشمیمعمولًارنگین.
دیبارخ	ازنامهایبرگزیده
دین	داور،داوری
دینا	داور،داوری؛(دراوستایی)دین؛(درعبری)(=دینه)انتقامیافته؛نامخواهریوسف(ع)
دیناز	خالقزیبایی
دینه	نامدختریعقوب(ع)وخواهریوسف(ع)
ذَلفا	دخترسفیدروی؛شاعرهمعاصرخلفایعباسی،دخترابیضزنومعشوقهینجدهیابناسود.

رَسابانو	بانویبرگزیدهوبلندبالابرگشتبهلیست
رَسادخت	دختربرگزیدهوبلندبالا
رَسپینا	فصلپاییز
رَستا	رَستن،رهیدن+ا(پسوند)،رستگارشده،رهایییافتهوخلاصشده
رُزا	گلرز
رُکسان	روشنک،رکسانا
رُکسانا	روشنک،نامدخترداراکهاسکندربهموجبوصیتدارااورابهازدواجخوددرآورد.
رُونیا	آنکهچهره‌اشمثلنیاکاناست
رُونیا	آنکهچهرهاشمثلنیاکاناست؛(بهمجاز)اصیل
رابو	نامگلیازگلهایبهاری
رابیا	مشهور،نامدار
راتا	نامفرشتهایاست
راحل	دخترمهاجر
راحیل	نامیکفرشته
رادا	راد+ا(پسوندنسبت)،منسوببهراد
راددخت	دختربخشندهیاخردمند
رادنوش	ازنامهایبرگزیده
راز	آنچهازدیگرانپنهاننگاهداشتهمیشود،سِر
رازان	نامروستاییدرنزدیکیخرمآباد
رازک	گیاهیعلفیازخانوادهشاهدانهکهمعطر،تلخ،وداروییاست
رازمهر	ازنامهایبرگزیده
رازیانه	گیاهیخوشبو
رافعه	اوجدهنده،رفیعکننده(باعثافتخار)
رافونه	پونه
رامافزا	افزونکنندهآرامش
رامافزون	رامافزا،افزونکنندهآرامش
رامبانو	بانویآرامیابانویشاد
رامدخت	ازنامهایبرگزیده
رامدخت	دخترآرام
رامش	شادی،خوشی،لذت،حظ،آسودگی،آسایش،سرود،نغمه
رامشین	نامروستاییدرنزدیکیسبزوار
رامک	آرامشدهنده
رامونا	مظهرعشق،لاتیننگهبانعاقل
رامی	منسوببهرام
رامینا	رامین+الف(نسبت)،منسوببهرامین؛دخترِطربناک
رامینه	رامین
راوش	مصحفزاوش،نامستارهمشتری
راویز	خارشتر
راویس	صاحبجاهوجلال
رایا	رای،فکر،اندیشه،تأمل
رایان	اسمکوهیدرحجاز
رایحه	عطرخوش(رایحهالجنت)،عطرحضرتزهرا
رایکا	پسندیدهودوستداشتنی
رایومند	دارندهفروغوشکوه
رخسار	روی،چهره،صورت،سیما
رخساره	چهره،صورت،گونه
رخشا	رخشان،درخشان
رخشان	درخشان
رخشانه	رخشانودرخشنده
رخشنده	درخشان،نورانی
ردیمه	نامزنکمبوجیهودخترهوتن
رزیتا	نامیفرانسویبهمعنیگلرزکوچک
رسا	بالغ،بلند
رسپینا	فصلپاییز
رستاک	شاخهتازهایکهازبیخدرختبرآید
روبیتا	بی‌نظیر
روجا	منسوببهروج(روز،آفتاب)؛(بهمجاز)زیبارویوآفتابچهره؛روجانامدهیدرتنکابن
رودابه	فرزندتابانومادررستمدستان
روژیا	روزوروشنایی
روژیار	روزگار
روژین	منسوببهروز،تابناکودرخشنده
روژینا	منسوببهروز
روشان	روشن
روشنک	دختردارا
روناک	روشن،تابناک
رونیکا	رویزیبا،زیباروی
رویا	خاطره‌هایشیرین
رها	نجاتیافته،آزاد
ریحانه	گیاهیخوشبویکهدرزمیننرمروید
ریرا	درگویشمازندرانیبهگوشباش،بههوشباش
ریواس	گیاهیباشاخه‌هایسپید

زُمرد	گوهر،ازسنگ‌هایقیمتیبرگشتبهلیست
زُبیده	نامگیاهی(همیشهبهار)؛دخترجعفرابنمنصورزنهارونالرشیدومادرخلیفهامین.
زُلفا	(زلف=مویبلندِسر،گیسو+الف(پسوندنسبت))،منسوببهزلف؛
زُلفا	منسوببهزلف؛نزدیکیومنزلتوقربَت.
زادک	نامروستاییدرنزدیکیقوچان
زادمهر	برآمدهازروشنایی
زاکیه	نیکو،پاکیزه
زامیر	آواز
زانوس	نامیکیازدوشعبهبزرگرودچالوس
زاهده	مؤنثزاهد
زرافشان	افشانندهسیموزر
زراندام	ازنامهایبرگزیده
زربانو	نامدختررستموخواهربانوگشتاسب
زربین	سروکوهی
زرپری	آنکهچونزروپریدرخشندهوزیباست
زرتا	همتایزر،درخشانوزیباچونطلا
زرتاج	زر(فارسی)+تاج(فارسی)زرینتاج
زرخاتون	زر(طلا)+خاتون(بانو)
زردخت	مرکباززر(طلا)+دخت(دختر)
زردیس	بهشكلزر
زرستان	نامدخترارجاسب
زرشام	نامدختریازخاندانجمشیدپادشاهکیانی
زرکا	بهزبانگیلکیبهمعنینوعیپرنده
زرگل	زرینگل
زرگیس	ازنامهایبرگزیده
زرگیسو	ازنامهایبرگزیده
زرمان	مانندزر،بسیارزیبا
زرناز	مرکباززر(طلا)+ناز(کرشمه)
زرنگار	ازنامهایبرگزیده
زرنگیس	زرینگیسزرینگیس
زرنوش	امشهریکهداراآنرابناکردهبود
زرواندخت	اززروان(نامایزدی)+دخت(دختر)
زری	منسوببهزر،زردار
زرین	ازجنسزر،بهرنگزر،طلایی
زرینبانو	ازنامهایبرگزیده
زرینتاج	زرین(فارسی)+تاج(معرب)آنکهتاجیازطلابرسردارد.
زرینچهر
زریندخت	مرکباززرین(طلایییاازجنسزر)+دخت(دختر)
زرینگل	آنکهچونگلیزرینزیباودرخشاناست
زرینگیس	آنکهموهاییبهرنگطلادارد،نامزنیدرمنظومهویسورامین
زرینمهر	خورشیدطلایی
زریننرگسه	ستاره‌هایآسمان
زریننگار	آراستهشدهبازر
زرینهمای	همایزرین،آفتاب
زرینهور	خورشیدطلایی
زرینه	ساختهشدهازطلا
زعفران	گیاهیعلفی،چندسالهوازخانوادهزنبقکهگلهایپاییزیسفیدیابنفشدارد.
زکیه	مؤنثزکی،پاک،طاهر،پارسا
زگما	نامپلیدرزمانسلوکیانکهسلوکیهرابهشهرآپاماوصلمی‌کرد.
زلال	صافوشفاف،(بهمجاز)آبصافوگوارا،پاک،خالص
زلیخا	نامهمسرعزیزمصرکهمفتونزیبایییوسف(ع)شد.
زمانه	روزگار،چرخ
زمرد	نامسنگیقیمتیبهرنگسبز
زمزم	نامچشمه‌ایدرنزدیکیکعبه
زمزمه	صدایحرفزدنآهسته،صدایآوازخواندنآهسته
زمیرا	بلبل
زنبق	گلیدرشتبهرنگهایبنفش،سفید،یازرد
زوشا	زیبا،نیکو،دلربا،ازریشهاوستاییزوش،نامنیایمنوچهرپادشاهپیشدادی
زوفا	گیاهیپایاومعطرازخانوادهنعناع
زویا	زندگی،زنده،دوستداشتنی
زهرا	روشن،درخشان،نامدخترپیامبر(ص)
زهراناز	درخشندهونازنین،ترکیبیقشنگازنامزهرا
زهره	سیارهزهرهونوس
زهیرا	بهمعنیشکوفه‌دار،درختشکوفه‌دار
زیبالنساء	بهترینزنان،زیباترینزنان،
زیبا	آنکهیاآنچهدیدنشچشمنوازوخوشاینداست،دلنشین،مطبوع
زیبا	آنکهیاآنچهدیدنشچشمنوازوخوشاینداست،دلنشین،مطبوع
زیبادخت	ازنامهایبرگزیده
زیباچهر	آنکهچهره‌ایزیبادارد،زیبا
زیبارخ	آنکهچهره‌ایزیبادارد،زیبا
زیباروی	ازنامهایبرگزیده
زیبان	زیبا،خوشایند
زیبنده	شایسته،سزاوار،زیبا،آراسته
زیتون	ازاسامیقرآنی،نمادصلحوانساندوست
زیتونه	یکدانهزیتون
زینا	نامدخترنوحنبی
زینب	پاکیزگی،نامدرختیخوشبووخوشمنظر
زینت	آذین،آرایش،پیرایه،تزیین،حلیه،زیب،زیور
زیور	آرایش،پیرایه
زیورتاج	آنکهچونزیوروجواهریبرتاجمی‌درخشد.
زیوین	نقره‌ای،نقرهگون

ژاسمی	یاسمنبرگشتبهلیست
ژاسمین	یاسمن
ژاکلین	کنتسهنوتوهلند
ژالانه	گیاهیزیباوخودرو
ژاله	شبنم،قطرهبارانکهرویبرگدرختانمینشیند
ژالین	شعلهآتش
ژامک	اسمباستانیبهمعنایآینه
ژانت	مونثژان(ژان=یحیی،یوحنا،خداداد)
ژانیا	ازنامهایباستانی
ژانیتا	نامشهریدریوناندرکناردریاچهایبههمیننام
ژانین	نامدریاچه‌ایدریونان
ژانینا	نامشهریدریوناندرکناردریاچه‌ایبههمیننام
ژاوا	جاوهنامقسمتیازاقیانوسهندمیانجزیرهجاوهوسوماتراوبرنئو
ژاوه	نوعیگیاهوحشیازتیرهکاکوتی
ژاییژ	شرارهآتش
ژربرا	گلیزینتیبهشکلمیناولیبسیاردرشتترازآنبهرنگهایصورتیتاسرخ
ژرفا	عمیق،عمیقترینیادورتریننقطهجایی
ژرفی	عمق،ژرفا
ژرفین	عمیق
ژرویرا	ژریرا
ژنیا	ژنیک
ژنیک	بااستعداد،نابغه
ژوان	زمان،میعاد،ملاقات
ژون	بت،صنم
ژیانچهر	ازنامهایبرگزیده
ژیاندخت	ازنامهایبرگزیده
ژیژیس	نامندیمهپروشاتهمسرداریوشپادشاههخامنشی
ژیکان	قطرهیباران(بهمجاز)زلالوشفاف،زیباوآرامشبخش
ژیلا	ژالهتگرگ
ژیلا	ژالهتگرگ
ژینا	باهوش،بانابغه،ژنیک
ژینوس	باهوش،نابغه،ژینا
ژیوار	نامکوهیدراورامان،زندگیکردن

سَرو	ازانواعدرختانکههمیشهسبزاست؛(بهمجاز)شادابوباطراوتبرگشتبهلیست
سَحرناز	(عربیفارسی)زیباییسپیدهدم؛(بهمجاز)زیبا
سَرور	آنکهمورداحتراماستونسبتبهدیگرییادیگرانسِمَتبزرگیدارد؛فرمانده،رئیس،بزرگ
سَروناز	سرونورسته،سرویکهشاخههایآنبههرطرفمایلباشد؛نامنواییدرموسیقیایرانی
سَروین	شبیهسَرو؛(درکردی)روسریوچارقد
سَریر	زیبا،تختپادشاهی
سَلین	سیلمانند؛نامرودخانه‌ایدرآذربایجان
سَلینا	منسوببهسَلین
سَما	آسمان
سَهی	صفتسرو
سُرنا	نوعیسازبادی
سُرنا	بهضمسینوسکون
سُلدا	حامی،یاور
سُها	ستارهیکمنوریدرکنارستارهیعناقدرصورتفلکیدُباکبر
سِتیا	گیتی،دنیاوروزگار
سابرینا	مژده،بشارت
سابو	هاله،خرمنماه
ساتی	درمصرباستان،نامفرشتهنگهبانارواح
ساتیا	ازنامهایباستانی
ساتین	محبوبودوستداشتنی
ساجده	دخترسجدهکننده(عبادتکنندهخدا)
سارگل	گلزرد
سارنگ	نامپرنده‌هایکوچکبهرنگسیاه،سار،ساری؛گوشهایدرآوازابوعطا؛نامسازیمثلکمانچه
سارنیا	خالص،پاک،منزه،بانویبیریا،دخترپاکدامن
ساریان	نامروستاییدرنزدیکیمشهد
سارینا	خالص،پاک
ساعده	دخترمددیار،یاریکننده
ساغر	ظرفیکهدرآنشرابمینوشند،جامشراب؛دلعارفاستکهانوارغیبیدرآنمشاهدهمیشود.
سالمه	بدونعیب،درکمالسلامت
سالی	بیغموسرخوش،سالمندودارایعمرطولانی،نامروستاییحوالیخرمآباد
سالینا	سال+ین(پسوندنسبت)+ا(پسوندنسبت)،منسوببهسال
سامره	نامشهریدرعراقکهمرقدامامدهمویازدهمدرآنواقعشدهاست
سامه	عهد،پیمان،جایامنوامان،پناه،مأمن
سامیرا	سمیرا،زنبزرگوار،نامعمهشیریندرداستانخسرووشیرینترجمهعربیمهینبانواست
سامینا	مانندمینا؛نامگلی
سامیه	یعنیبانویبلندمرتبهوازالقابحضرتزینب
ساناز	نامگلی؛کمیاب،نادره
سانای	بیقرار
سانلی	معروف،مشهور
سانوا	دخترخوشسخن،بانوییکهشیرینحرفمی‌زند.
سانیا	سایهروشنِجنگل
ساوی	باارزش،گرانمایه
ساویز	خوشخلقونیکخو
ساویس	باارزش،گرانمایه
ساهره	چشمهروان
سایا	یکرنگ،بیریا
سایان	منسوببهسایه،نامرشتهکوهیدرآسیایمرکزی
ساینا	سیمرغ،عنقا
سایه	تاریکینسبی،پناه،حمایت؛حشمتوبزرگی.
سبا	سوره34قرآنکریم،شهریدریمنکهبلقیسملکهآنجابوده،درعبریبهمعنیانسان
سبارو	کبوتر
سبزبهار	نامیکیازالحانقدیمایرانی
سبزپری	فصلبهار
سبزه	سبزهوار،چمنزار،گندمگون
سپتا	خوب،خوبی
سپیتا	سفیدترینوپاکترین
سپیدار	درختیازخانوادهبیدبابرگهاییبراق
سپیده	نوراولصبح،سفیدروی
سپیدهگل	گلسپید
سپینود	درشاهنامهدخترپادشاههند(شنگل)وزنبهرامگور
ستاره	؛بختواقبالونمادشخصمجلسآراوزیبارو
ستاک	شاخهتازهرستهونازک
ستایش	ستودن،تعریف
ستایش	حمدوسپاسخداوند،شکرگزاری(بهدرگاهخداوند)؛تعریفوتمجید
ستوده	آنکهاوراستوده‌اند؛ستایششده
ستیا	جهان،هستی،دنیا،روزگار-بانوینجیبوبلندمرتبه–لقبحضرتمعصومه
ستیلا	نامدخترامامموسیکاظمولقبحضرتمریم
سداب	نامگیاهیاست
سدنا	سجدهکنندهبرخانهخدا
سرآویز	آنچهبهسرمی‌آویزند
سرمه	(بهمجاز)سیاهی،تاریکی
سرور	شادمانی
سروناز	زنزیبا،درختسروناز
سروین	شبیهسرو،مانندسرو
سلاله	نسل،ازالقابحضرتزهرا
سلوا(سلوی)	نوعیپرنده(بلدرچین)درقرآنکهدربهشتهمهست
سلین	نامرودخانهایدرآذربایجانکهازقرهداغسرچشمهمیگیرد
سمن	رازقی،یاسمن
سمن	یاسمن
سنا	روشنایی
سودابه	یکیازشخصیتهایشاهنامه
سوره	سورهقرآن
سوری	رزقرمز
سوزان	شعلهور،درحالسوختن،سوزاننده
سوسن	نامگلی
سوفیا	اسمیباریشهیونانیبهمعنایخرد
سوگل	موردعلاقهومحبتزیاد،محبوب
سوگند	قسمخوردن
سونیا	(سو=نور+نیا)نورِنیاکان،(دریونانی)خردوعقل،دخترنور
سویل	(تلفظ
سوین	(ترکی)شادباش–عشق،محبت،علاقهشدید
سیگل	سیعددگل
سیتا	جهان،گیتی
سیما	صورت،رخ
سیمبر	دارندهاندامسفیدوزیبا
سیمروی	سپیدروی
سیمگون	نقرهفام
سیمیا	بلاغت،فصاحت
سیمین	نقرهفام،سفید
سیمینچهر	سپیدروی
سیمیندخت	دخترسپیدباصفتهایدرخشان
سینره	گیاهیزینتیونیزدارویی،پامچالفر
شِیدا	عاشق،دلداده؛آشفتهوپریشانبرگشتبهلیست
شاپرک	نوعیپروانهبزرگکهمعمولاًشبپروازمیکند.
شاپری	شاهپری
شاخسار	محلانبوهیشاخههایدرخت
شادآفرید	ازنامهایبرگزیده
شادان	شاد،مسرور؛(درحالتقیدی)باحالشاد،شادمانه
شادانه	شاهدانه
شادآفرید	آنکهشادآفریدهشد،آفریدهشاد
شادبانو	ازنامهایبرگزیده
شادبهر	آنکهازشادیبهرهدارد،خوشحال
شادپری	ازنامهایبرگزیده
شاددخت	دخترشاد
شاددل	ازنامهایبرگزیده
شادرخ	آنکهچهرهایشادومتبسمدارد.
شادرو	آنکهرویوچهرهاششاداست،شاداب،شادمانومسرور
شادروز	نیکروز،خوشبخت،کسیکهروزششاداست.
شادروی	ازنامهایبرگزیده
شادفر	آنکهدارایشکوهوشادیاست.
شادک	ناممستعارسمکدرداستانسمکعیار
شادکام	شادمان،کامران،کامروا
شادکامه	کامروا،خوشحال،شادمان
شادگل	آنکهچونگلشاداباست.
شادگون	شادوخوشحال
شادلی	شادروینرمخووآرام
شادلین	نرمیوملایمت،آراموخوشچهره
شادمان	خوش،مسرور
شادمانه	شادمان،شاد،خوشحالومسرور،باشادیوخوشحالی
شادمهر	ازنامهایبرگزیده
شادناز	ویژگیآنکهشاداستوباعشوهونازاست.
شادنوش	شادیوشادمانیهمیشگیوجاوید
شادور	شادمان،خوشحال
شادی	وضعوحالتشاد،شادبودن،خوشحالی،سرور؛جشن
شادیافزا	افزایندهشادیونشاط
شادیآور	ازنامهایبرگزیده
شادیا	بانویشاد،دخترشادوسرخش،منسوببهشادی
شادیان	ازرویشادی،براساسشادی،آهنگونوایشادیآور
شادیانه	ازرویشادی،براساسشادی،آهنگونوایشادیآور
شادیه	منسوببهشادی
شارونا	سرزمینپرباروحاصلخیز
شارین	متمدن،شهرنشین،مرکبازشاربهمعنایشهر+ین(پسوندنسبت)،نامدهیدرقزوین
شانا	بادملایم
شاندیز	شکوهمندودارایعظمتوجلال،شاهاندژ،نامروستاییدرنزدیکیمشهد
شاهدخت	شاهدختر،دخترشاه
شاهرو	ازنامهایبرگزیده
شایا	شایان
شایسته	باارزش،سزاوار
شایلی	بیهمتا
شایلین	اسمیترکیبهمعنیبیهمتا
شاینا	شاهدانه
شببو	گلیمعطروزینتیدررنگهایمختلفباساقهیبلند
شبپره	پروانه،خفاش
شبدیس	مانندشب
شبنم	ازاسامیدخترانهقطرهایکهشباهنگامرویبرگگلمینشیند
شبنم	رطوبتهواکهمخصوصاًهنگامشب
شراره	ازنامهایرایجامروزی
شرمین	ازنامهایبرگزیده
شروین	نامقلعهیشروان
شکرانه	شکرگزاری
شکربانو	ازنامهایبرگزیده
شکرناز	ازنامهایبرگزیده
شکفته	ازنامهایبرگزیده
شکوفا	شکفتهشده
شکوفه	گلدرخشانمیوهدار
شکوفه	گل‌هایرنگارنگمیوه
شکوه	بلندجایگاه،باعظمت
شکیبا	ازاسامیدخترانهبهمعنیصبور،بردبار،باشکیبایی
شگون	خجستگی،باشانس
شمسا	دختریکهمانندخورشیداست،درخشانوپرتوافشان
شمیس	خورشیدکوچک
شمیلا	نسیموبادشمال
شمیم	ازاسامیدخترانهبهمعنیبویخوش
شنایا	همهچیزدان
شوانه	گلهبان،چوپان
شورانگیز	ازنامهایبرگزیده
شوکا	نوعیگوزنبومیاروپاوآسیا؛درمازندرانیبهآهووغزال
شهربانو	نامزنرستم
شهرخ	ازنامهایبرگزیده
شهردخت	ازنامهایبرگزیده
شهرزاد	نامدختریزیبادرقصههزارویکشب
شهرزاد	ازنامهایبرگزیده
شهرناز	نامخواهرجمشید
شهرنواز	خواهرشاهجمشیدپیشدادی
شهرو	ناممادربرزویهپزشک
شهرود	نامزنسهرابومادریرزو
شهگل	بهترینگل،گلِشاهانه
شهلا	ازنامهایبرگزیده
شهناز	ازنامهایبرگزیده
شهنواز	ازنامهایبرگزیده
شهین	ازنامهایبرگزیده
شهینبانو	ازنامهایبرگزیده
شیدا	شیفته
شیدبانو	ازنامهایبرگزیده
شیددخت	ازنامهایبرگزیده
شیدرخ	ازنامهایبرگزیده
شیده	روشنایی،خورشید
شیرین	مزهشادکامی
شیرینگل	ازنامهایبرگزیده
شیفته	عاشق،مجنون
شیلا	نامنهریدرسیستانوبلوچستان،ازنامهایمتداولهندی
شیما	زنیکهرویچانهاشخالدارد،زنزیبایعرب،نامدخترحلیمهسعدیهدایهپیامبر(ص)
شیوا	رسا،فصیح،بلندوکشیده

صَبا	پیامرسانمیانعاشقومعشوقبرگشتبهلیست
صُراحی	ظرفشراب،ظرفشیشهایشراب؛شرابزلال؛درتصوفمقامانسراگویند.
صالحه	دختروزننیکوکار
صبرا	بردباریکردندربرابرسختیهاوناملایمتها،شکیبایی
صبورا	صبور+ا(الفنسبتیاتعظیم)،بهمعنیبردبار،صبور
صحرا	بیابان؛محلیخارجازمنطقهمسکونی،کهدارایپوششگیاهیاست.
صدف	ازاسامیدخترانه،نامسهستارهبهشکلمثلث
صنم	بتزیبا
صنوبر	نامدرختیهمیشهسبز
صوفیا	منسوببهصوفینواییدرموسیقی
صونا	دوریازگناه،خویشتنداریازگناه
صهبا	شرابانگوری.شرابیکهمایلبهسرخیباشد
ضحی	سپیدهصبح،درقرآنبهشقسمخوردهشده
طَراوت	تروتازگی؛(بهمجاز)سامانورونقبرگشتبهلیست
طُلوع	دمیدنوبرآمدنِخورشیدومانندآن؛ابتدایروز
طاهره	طاهر،زنپاکومبراازعیب،لقبفاطمهزهرا(ع)ولقبخدیجههمسرپیامبر(ص)
طرفه	شگفتآور،جالب،عجیب
طناز	ازاسامیدخترانهبسیارزیبا،دلنشینوفریبنده
طنان	پرطنین،بلندآوازه،مشهور
طنین	انعکاسصوت،پژواک؛حالتیازصداکهدارایتأثیرونفوذباشد؛خوشآهنگی
طهورا	پاکیزه،پاککننده،ازاسامیقرآنی(شراباطهورا)
طیلا	شرابیکهازجوشاندنفشردهانگور،مویز،یاخرمابهدستمی‌آید.
عادله	مؤنثعادل،بانویباانصاف
عارفه	زنعالموعارف
عرفانه	عرفان(عربی)+ه(فارسی)مرکبازعرفان(معرفت)+ه(پسوندنسبت)
عسل	مایعیخوراکیکهزنبورعسلمیسازد،بسیارشیرینودوستداشتنی
عطرین	منسوببهعطر،دلانگیز،معطر،خوشبو
عطیه	انعام،بخشش
غَزل	نوعیشعر،شعرعاشقانه
غدیره	گیسویبافتهشده،مونثشدهکلمه(غدیر)
غزال	نوعیآهویظریفانداموبسیارتندروباچشماندرشتسیاه
غزاله	نوعیآهو
غزلناز	غزل(عربی)+ناز(فارسی)مرکبازغزل(شعرعاشقانه)+ناز(زیبا)
غنچه	گلیکهشکفتهنشده
غنچه	گلنیمهباز
غوغا	صدایبلند،بانگوفریاد

فاتن	فتنهانگیز،آنکهآشوببپامی‌کندبرگشتبهلیست
فاتیما	فاطیما،نامشهریاستدراروپاکهحضرتفاطمهدرآنجاظهورکردهاست
فارا	نامکوهیاستکهدرغربفلاتایرانواقعشدهاست.
فارهه	دخترزیباوبانمک
فاسیروس	نامدختراردشیردرازدستپادشاههخامنشی
فاطمه	نامدخترپیامبر(ص)،زنیکهبچهخودراازشیرگرفتهباشد
فامگل	بهرنگگل
فانیذ	قندوشکر
فانیذ	پانیذ،قند،شکر
فایدیم	بهمعنایگلنیلوفراست،نامهمسرکبوجیهپادشاههخامنشی
فائزه	نائل،رستگار،ازاسامیقرآنی
فائقه	پیروزشده
فراتاگون	نامدخترآرتان،برادرداریوشبزرگ
فراچهر	مرکبازفرا(بالاتر)+چهر(صورت)=آنکهصورتیزیباترازدیگراندارد.
فرارنگ	فرانک،پروانه،ازشخصیتهایشاهنامه،ناممادرفریدونپادشاهپیشدادیوهمسرآبتین
فرازنده	بالابرندهوافرازنده
فرانک	پروانه،ازشخصیتهایشاهنامه،نامدختربرزینوزنبهرامگور،
فرانه	فرانک
فرآذر	شکوهآتش
فربو	مرکبازفر(شکوه)+بو=بووعطرشکوهومنزلت
فرپرک	شبپرهکهآنرامرغعیسینیزمینامند.
فرتوک	پرستو
فرجهان	شکوهدنیا
فرخ	اسمدخترانهوپسرانهبهمعنیخجسته،مبارک،فرخنده،نامیکیازمرزبانانخسروپرویزپادشاهساسانی
فرخبانو	بانویبزرگواروفرخنده
فرخبخش	بخشندهبزرگوار،نامیکیازبهدینانیزدکهدرسالهشتادوهشتیزگردیمیزیستهاست.
فرختاج	فرخ(فارسی)+تاج(فارسی)مرکبازفرخ(مبارک)+تاج
فرخچهر	دارایچهرهفرخندهومبارک
فرخماه	ماهخجستهومبارک
فرخناز	ازنامهایبرگزیده
فرخنده	مبارک،پرارج
فرخندهچهر	دارایچهرهمبارکوخجسته
فردخت	مرکبازفر(شکوه)+دخت(دختر)
فردوس	ازاسامیدخترانهبهمعنیپردیس،یهشت
فردیس	پردیس،بهشت
فرزان	ازنامهایبرگزیده
فرزاندخت	دخترفرزانهودانا
فرزانه	گرامی،ارجمند
فرسیما	فر(فارسی)بهمعنایشکوه+سیما(عربی)،آنکهصورتیباشکوهدارد.
فرشته	موجودیآسمانی
فرشته	ازنامهایبرگزیده
فرگون	مانندروشنایی
فرمهر	کسیکهشکوهوعظمتیچونخورشیددارد.
فرناز	ازنامهایبرگزیده
فرنگیس	نامدخترافراسیاب،زنسیاوش،مادرشاهکیخسروکیانی
فرنوش	ازنامهایبرگزیده
فرنوشا	شکوهوعظمتابدیریشه
فرنی	بسیار،افزونوفروزان
فرنیا	دارندهاصلونسب
فرنیار	اصیل،دارندهاصلونسب
فرنیان	پرنیان،ابریشموحریر،دختریکهدارایجسمیبسیارلطیفوزیباست.
فروردین	نخستینماههرسال
فروزان	نورانی،شعلهور
فروزش	روشن
فروزنده	ازنامهایبرگزیده
فروغ	روشنایی،تابش
فروغبانو	ازنامهایبرگزیده
فریال	دارایانداموهیکلباشکوه،قویوباشکوه،مرکبازفر(شکوه)+یال(گردن،بالایبازو)
فریبا	فریبنده
فریسا	پریسا،زیباچونپری
فریماه	ازنامهایبرگزیده
فرین	نامیکیازدختراناشوزرتشت
فریناز	ازنام‌هایبرگزیده
فصیحه	فصیحوگویا،بانویفهمیده
فلامک	الماسگلیرنگ
فلورا	فلوریا،دررمباستان،الههگلهاوبارآوری
فهیمه	فهیم
فیروزه	نامسنگیقیمتیبهرنگآبییاسبز
فیروزه	نگینانگشتر
قُدسی	مربوطبهعالمبالا،مربوطبهعالممجردات،ملکوتی؛(بهمجاز)فرشته
قُدسیه	مؤنثقدسی
قاصدک	گلپیامرسان
قاصدک	گلقاصدک
قاهره	مؤنثقاهر،نامپایتختمصر
قدسی	مقدس،فرشته
قدیره	مؤنثقدیر،توانا
قشنگ	زیبا،خوشگل
قشنگگل	گلزیبا،دختریکهچهرهاشمثلگلزیباولطیفاست.
قصیده	نامیکیازقالبهایشعرفارسیوعربی
قصیده	نامیکیازقالب‌هایشعرفارسیوعربی
قطره	مقدارکمیازمایعکهازجاییبچکد،چکه
قمر	ماه؛جِرمآسمانیکهدورسیاره‌ایبچرخد؛(بهمجاز)زنزیباروی
قمرالزمان	ماهدوران؛نامیکیازشخصیت‌هایهزارویکشب
قمرالملوک	آنکهمیانپادشاهانچونماهمی‌درخشد.
قمرتاج	تاجماه
قمرسیما	ویژگیآنکهچهره‌اشمثلماهمیباشد؛(بهمجاز)زیبارو
قمرناز	ماهناز،آنکهچونماهزیباست.

کُنیا	دختریکهازدواجنکردهاستبرگشتبهلیست
کاترینا	کاترین،بهمعنیپاکوبیآلایش
کارولین	نامناحیهایدرآمریکایشمالی
کاس	اسمزیبایشمالیبهمعنیدخترچشمآبی
کاساندان	همسرکورشبزرگ
کاساندان	نامزنکوروشبزرگومادرکمبوجیه
کاشین	ناممحلهدرشمالایلام
کامدل	ازنامهایبرگزیده
کامروا	خوشبخت،خرسند
کامله	مؤنثکامل،بینقص،بیعیب
کاملیا	گلیدرشتوزیباسفیدوصورتیرنگکهدربهارظاهرمیشود.
کامه	خواسته،آرزو،مراد،هدف،خواهش
کامیشا	خوشحال،سرزنده،خوشبیان،ترکیبمغلوبوتغییریافته“شادکام”
کامیلا	محافظمعبد،نامدختریجنگجودرافسانهتروااسمدختر
کاناز	چوبریشهخوشهخرما،اسماصیلایرانی
کانی	چشمهآب،کنایهازتازگیونشاطوطراوتاست.
کاویش	پیمانهشیر
کبرا	کبری،بزرگ،کبیر
کبریا	بزرگیوعظمت
کبریا	بزرگی،عظمت
کبیتا	نوعیشیرینی
کتایون	دخترقیصرروموزنگشتاسبومادراسفندیار
کتایون	کسایون،اسمیکیازدخترانقیصررومونیزهمسرگشتاسپپادشاهکیانی.
کرا	اسمهمسرمولاناجلالالدینبلخی
کرامت	بزرگواری،شرافت،سخاوت،بخشندگی
کرانه	ساحل،گوشه،کنار،سو،جهت
کردیا	دخترکرد
کرشمه	نازوغمزه،نامنواییدرموسیقی
کریمه	مؤنثکریم،بخشنده،سخاوتمند
کژال	غزال،دختریباچشمانزیبا
کشور	سرزمینیدارایمرزهایمشخصکهازسایرسرزمینهاجداشدهاست.
کشوربانو	ازنامهایبرگزیده
کلارا	چشممردمکچشم
کلاله	بخشیازگلکهبرایجذبدانههایگرده،نگهداشتنورویاندنآنهاوتولیدمیوهاست،زلف،کاکل
کلثوم	اسمیکیازدخترانحضرتعلی(ع)
کمانه	منسوببهکمان
کمند	آنچهبهوسیلهآنکسیراگرفتارمیکنند
کمند	دام،کنایهازگیسو
کوثر	نامچشمه‌ایدربهشت،نامسورهایدرقرآنکریم
کوچیار	یارکوتاهقد(نگارشکردی
کوشانه	دخترساعی،بانویتلاشکر
کوشک	کاخ،قصر،اسمدخترایرج(پسرفریدونپادشاهپیشدادی)
کوکب	ستاره،گلیزینتیودرشتوپُرپَربهرنگهایارغوانی،سفید،قرمز،زردیابنفش
کوکبه	شکوه،جلال
کوهینه	پونه
کهربا	نامصمغیسختشدهوزردرنگکهخاصیتجاذبهدارد.
کهسار	کوهسار،جاییکهدارایکوههایمتعدداست.
کیآفرید	مرکبازکی(پادشاه)+آفرید(آفریده)=کسیکهشاهآفریدهشده.
کیآفرین	آفرینندهپادشاه
کیبانو	ازنامهایبرگزیده
کیدخت	دخترپادشاه
کیادخت	دخترپادشاه
کیارا	اندوهوملالت،میلشدیدبهخوردنانواعخوردنیجات
کیارنگ	ازنامهایبرگزیده
کیانبانو	ملکه
کیاندخت	دختریازنسلشاهان،شاهزاده
کیانا	برخواستهازنسلکیانیان
کیانا	طبیعت،اهلهرچیز
کیانبانو	ازنامهایبرگزیده
کیاندخت	ازنامهایبرگزیده
کیانه	منسوببهکیان،پادشاهی
کیجا	دختر
کیجانا	دخترمازندرانیکهعزیزودوستداشتنیاست.
کیسر	ازنامهایبرگزیده
کیمیا	ازاسامیدخترانهبهمعنیاکسیر،هرچیزنایابودستنیافتنی،افسون
کیناز	بهکسرکاف،موجبافتخارپادشاه،دختریکهپادشاهنازکشاوست
کیوانبانو	ازنامهایبرگزیده
کیواندخت	مرکبازکیوان(نامستاره‌ای)+دخت(دختر)
کیوانچهر	ازنامهایبرگزیده
کیواندخت	ازنامهایبرگزیده
کیوانرخ	ازنامهایبرگزیده
کیوانزاد	ازنامهایبرگزیده
کیهاندخت	مرکبازکیهان(دنیا)+دخت(دختر)
کیهانه	کیهان،جهانهستی،دنیا،گیتی
گُلان	منسوببهگل؛گلها؛(بهمجاز)زیباروولطیف
گرامیدخت	گرامی+دختر=دخترعزیزومحترم
گراناز	گرانناز
گرانمهر	آنکهمهرومحبتبسیاردارد،بسیارمهربان.
گرانناز	دارایناز،کرشمهوغمزه‌یفراوان؛دارنده‌یقشنگیوزیباییزیاد؛جذابوخوشایند
گردآفرید	دخترجنگاورایرانیکهدردژسپیددرمرزایرانوتورانباسهرابجنگید،فرزندگژدهم
گردآفرین	گُردآفرید
گردیا	بکیازشخصیتهایشاهنامه
گردیه	ازشخصیتهایشاهنامهفردوسی،نامخواهربهرامچوبین(سردارساسانی)
گشتا	بهشت،پردیس
گشین	(گش=خوب،خوش،بانازراهرفتن+ین(پسوندنسبت))،(بهمجاز)زیباودوستداشتنی.
گلافروز	مرکبازگل+افروز(افروزنده)
گلافشان	افشاننده‌یگلیاریزنده‌یگل،گلفشان
گلاندام	دارایپیکرظریفوزیباهمانندگل
گلآذین	زینتگل،آرایشگل،چگونگیقرارگرفتنگل‌هابررویساقه
گلآرا	زینتدهندهگل،ازشخصیتهایشاهنامه،ناممادرروشنکبنابهبعضینسخههایشاهنامه
گلآسا	مانندگل
گلآور	(گل+آور(جزءپسین)=آورنده،دارنده)،گلآورنده،گلدارنده؛(بهمجاز)زیباوباطراوت
گلآویز	مرکبازگل+آویز(آویختهشده)
گلبهار	گلیکهدربهارشکفتهمی‌شود،شکوفهگل
گلپر	دانهمعطریبهشکلپولکهایزردکوچککهداروییاست.
گلپرست	دوستدارگل
گلپری	زیباچونگلوپری
گلپناه	پناهگل
گلتاج	تاجیپرازگل
گلجهان	گلجهان،بهترینوزیباترینگلدرجهان
گلدانه	دانهگل
گلشید	گلیکهچونخورشیدمیدرخشد
گلاب	مایعخوشبوییکهازتقطیرگلسرخوآببهدستمی‌آید.
گلابتون	رشته‌هاینازکطلاونقرهکههمرهتارهایابریشمدرزریبافیبهکارمی‌رود.
گلاره	مردمکچشم،حبهانگور
گلاره	چشمان
گلاسا	مانندگل،مرکبازگلوپسوندمشابهت
گلاله	کاکلمجعد،مویپیچیده
گلبَر	آنکهآغوششچونگللطیفونازکاست؛گونه‌ایازگلها
گلباران	برایتمجیدواحترامزیاداستفادهمی‌شود.
گلبان	نگهدارندهومحافظ،ناممادرابرانواسشاعرایرانیقرندوم
گلبانو	بانوییزیباچونگل
گلبخت	(گل+بخت=سرنوشت،طالع)،(بهمجاز)زیباولطیفودوستداشتنی.
گلبر	آنکهسینهوآغوششچونگللطیفونازکاست.
گلبرگ	هریکازاجزایپوششیگل،چهرهورخسار
گلبن	بوتهیادرختگل
گلبو	ازشخصیتهایشاهنامه،نامدلاوریایرانیازهمراهانرستمهرمزانپادشاهساسانی
گلبوته	بوتهگل
گلبهار	گلفصلبهار
گلبیز	گلافشان،گلریز،معطر،خوشبو
گلپاد	نگهبانگل
گلپاره	قطعه‌یگل،تکهیگل؛(بهمجاز)زیباوباطراوت
گلپر	دانه‌یمعطریبهشکلپولک‌هایزردکوچک
گلپری	گل+پری=(بهمجاز)زیبارویودارایاندامظریف،
گلپسند	زیبارویموردپسند
گلپونه	گلهایکوچکمعطربهرنگصورتییابنفش،پونهجوانوتازه
گل‌پیکر	ویژگیآنکهپیکرشمثلگلزیباولطیفاست،گلاندام
گلدانه	دانهیکهباعثطراوتگلمیشود
گلدخت	دخترِگل،دخترِدارایصفاتگل
گلدیس	چونگل،مانندگُل؛(بهمجاز)زیباروولطیف
گلرخ	زیبارو،دختریکهچهرهایزیباچونگلدارد
گلرخ	زیبارودختریکهچهره‌ایزیباچونگلدارد.
گلرنگ	بهرنگگل
گلسا	گلسان،مانندگل
گلسان	گلسا،مانندگل
گلشن	باغگل
گلمهر	(گل+مهر=خورشید)،(بهمجاز)آفتاب،گلخورشید،گلآفتاب،گلآفتابگردان
گلنار	گلانار،بهزیباییگل
گلناز	داراینازوعشوهایچونگل
گلنوش	مرکبازگل+نوش(عسل)،نامیکیازلحنهایقدیمموسیقیایرانی
گلوریا	باشکوه،سرفراز
گلی	رنگقرمزگلرز
گندم	دانهخوراکیغنیازنشاسته
گهرناز	گوهرناز
گیتا	گیتی
گیتا	نوعیآهنگ
گیتی	جهان،عالم
گیتیناز	آنکهموجبفخرومباهاتجهاناست.
گیسو	مویبلندسر
گیلدا	طلا
گیلنار	ترکیبازگیل(گیلک)+نار(انار)
گیهان	کیهان،جهان،دنیا،گیتی
دختربچهزیبا

لَچَک	دستمالسهگوشبرگشتبهلیست
لادن	معربازیونانی،گلزینتیبهرنگزرد،قرمز،یانارنجی
لاریسا	نوعیسکهزینتیکهدرفارسضریمیشد
لاله	گلیبهشکلجاموسرخرنگ،گونهسرخوگلگون
لاله	گلیبهشکلجاموسرخرنگ،گونهسرخوگلگون
لالهچهر	آنکهچهرهوصورتیسروزیباچونگللالهدارد.
لالهدخت	مرکبازلاله(گلی)+دخت(دختر)
لالهرخ	لالهچهر،آنکهچهرهوصورتیسرخوزیباچونگللالهدارد.
لالهرخسار	لالهچهر،کسیکهصورتشزیباچونگللالهاست.
لالهرو	لالهچهر،آنکهصورتیزیبابهمثالگللالهدارد.
لالهزار	زمینیکهدرآنلالهفراوانروییدهاست.ناماصیلفارسی
لالهگون	همچونلاله
لالهوش	مانندلاله
لامیا	شهرینزدیکخلیجلامیا
لاون	نامجاییدرشاهنامه
لاوین	نوازشگر،آوازخواندنهمراهبانوازش
لایه	پوشش،نامزنیدررمانباغبلور
لبخند	احساسشادیبرلبان
لبخنده	لبخند
لبینا	نامیکیازلحنهایقدیمموسیقیایرانی
لتکا	باغ،باغچه
لطیفه	مؤنثلطیف
لعبت	زنزیبارویوخوشاندام،عروسک،بازیچه
لعل	معربازفارسی،لال،نامسنگیقیمتیبهرنگقرمز،گاهیسبزوزردتاسیاه
لعیا	نامزنحضرتیعقوب
لمیا	زنسیاهوگندمگون
لمیس	زنیباپوستنازکولطیف
لنا	نصیبوبهره
لنیا	(فارسی-سنسکریت)دخترملیح،نمکین،مرکبازلن(سنسکریت)+ینسبت(فارسی)+الف
لوتوس	گلنیلوفرآبییاسوسنشرقی،
لورا	نامسازیاست،چنگ.نامیکیازصورتهایفلکیشمالی
لؤلؤ	مروارید
لیا	دختربزرگ‘لابان’کهیعقوبِپیامبرویرابههمسریقبولکرد–خجسته،نامهمسریعقوب(ع)
لیا	خجسته،نامهمسریعقوب(ع)
لیالی	شب‌ها
لیان	درخشنده،نامروستاییدرنزدیکیبوشهر
لیانا	بانویدرخشانوزیباروی،مرکبازلیانبهمعنایدرخشانوالفتأنیث
لیدا	مهسان–مهسیما–مهسو-مهرشید
لیزا	بندهخالصخداوند
لیسا	نامروستاییدرنزدیکیقزوین
لیلا	شبطولانیوبسیارتاریک
لیلا	لیلی
لیلی	شبدراز،نامیکیازلحنهایقدیمموسیقیایرانی
لیلیا	شب،همریشهبا”لیل”عربیاست.
لیمو	میوهخوردنی،ترشیاشیرین،معطروزردرنگ
لینا	آبشارکوچک
لیندا	قشنگ،زیبا
لیو	خورشید،آفتاب
لئا	بهسویخدا،دختریکهروبهسویخدادارد.
مَهدیس	مانندماه؛(بهمجاز)زیباروبرگشتبهلیست
مَشیانه	نخستینآفریده،نامنخستینزن(حوا)
مَهرو	ماهرو،(بهمجاز)زیبارو
مَهگل	(مَه=ماه+گل)،گلِماه؛(بهمجاز)زیبارو
مُوژان	چشمخماروپرکرشمه،غنچهنرگس
مُهیمِن	آگاهبهحاضروغایب؛ازنامهاوصفاتخدا
مِهرسا	(مهر=خورشید+سا(پسوندشباهت))،مثلخورشید؛(بهمجاز)زیبارو
مِهرنیا	(مهر=مهربانی،محبت+نیا)،ازنژادِمهربانان؛(بهمجاز)مهربانوبامحبت
ماتیسا	ماهتیسا،درگویشمازندرانماهتنها
ماتینا	نامساتراپنشینولایتتحتامرحاکمباوالیدردورانهخامنشی
ماجان	مانندماه
مادیار	یاوروکمککنندهمادر،مددکاربرایمادر
مارال	گوزن،آهو
مارتا	فناپذیر،دنیایی
مریم	انگلیسیازعبری،مریم
مارینا	دارندهیهرچیزارزشمند،جویبار،آب
مالیندا	صالح,جدی,شاد
مامَک	مادر؛خطابمحبتآمیزبهفرزنددختر؛زنپیر
مانِلی	درگویشمازندرانبمانبرایم،نامیدخترانهدرشمالایران،نامپسریدرشعریازنیمایوشیج
مانا	ماندنی،پایدار؛(درپهلوی)مانندومانندبودن
مانترَه	سخنمنشانگیزومقدس،کلاماندیشهبرانگیز
ماندانا	عنبرسیاه،نامدخترپادشاهمادومادرکورش
ماندگار	کسیکهدرجاییاقامت(دایمیوطولانی)کند،پایدار،بادوام،ماندنی.
مانلی	مازندرانی(بمانبرایم)
مانیا	خانهوسرایامن
مانیا	خانه،سرای،معربازیونانی،دیوانگی،جنون
ماه	بسیارخوبودوستداشتنی
ماهآفرید	آفریده‌یماه؛زیبارو
ماهبانو	زنیکهچونماهمی‌درخشد
ماهپسند	قبولشونده،پسندیده،(بهمجاز)زیبارویچونماه
ماهپیکر	معشوقِزیبا
ماهجهان	زیبایجهان
ماهدیس	همچونماه
ماهرخسار	ماهچهر
ماهسمین	ماه
ماهگل	گلِماه؛(بهمجاز)زیبارو
ماهانا	ماهان+ا(پسوندنسبت))منسوببهماهان
ماهپری	بسیارزیبا
ماهتاب	پرتوماه،شعاعماه،نورماه،مهتاب
ماهتابان	زیبارو
ماهدخت	دخترماه،دختریکهمانندماهاست؛(بهمجاز)زیبارو
ماهرُخ	خوشگل،زیبا
ماهرخ	کسیکهچهرهایمانندماهدارد
ماهرو	آنکهچهره‌ایهمچونماهدارد،‌زیبارو
ماهک	خوبرویکوچک،معشوقکزیبارویویاخوبرویدوستداشتنی
ماهناز	(ماه+ناز=قشنگ،زیبا)ماهرویزیبا
ماهنگار	(ماه+نگار=معشوق)(بهمجاز)معشوقه‌یزیبارو
ماهنوش	ماهجاویدانوهمیشگی؛(بهمجاز)زیبارویهمیشهزیبا
ماهوَر	(ماه+وَر(پسونددارندگی))،زیبارو
ماهوار	مانندماه
ماهوش	مهوش،مانندماه؛(بهمجاز)رعناوزیباومعشوقه،زیباودرخشان
ماهین	(ماه+ین(پسوندنسبت))،منسوببهماه؛(بهمجاز)زیبارو
مایا	منشنیک،بخشنده؛(دررومباستان)اِلههیفراوانیسبزهوبهاردرنزدرومیان
مایسا	نامگیاهیکوچکویکسالهکهبسیارظریفاست.
مائده	خوردنی،طعام،نامسورهایدرقرآنکریم
مبینا	آشکاروروشن،ازاسامیکلاموحی
متینا	دخترمتینوباوقار
محدثه	مؤنثمحدث،گویندهسخن
محنا	ﺑﻪﺣﻨﺎﺧﺿﺎﺏﮐﺮدﻩ،بهضممیموفتححوتشدیدنون
محیا	یکیازصفاتخدا،زندهوپویا
محیصا	رستگارشده،پاکوآمرزیده(بهفتحمیم).
مرجان	ازگیاهاندریایی
مرسا	استواروثابت
مرسانا	هدیهخداوند
مرسده	زیبا،باطراوتوخرم
مرمر	سنگخوشرنگوقیمتی
مرمرین	ساختهشدهازمرمریاازجنسمرمر
مروا	فالنیکودعایخیر
مروارید	در،سنگیارزشمندوقیمتی
مروارید	گوهرباارزشدریایی
مژان	نرگسنیمهشکفته
مژده	خبرخوشوشادیبخش،بشارت
مژگان	مژه‌ها،چشمپوش
مستانه	سرخوشوشاد
مستوره	پنهان،پوشیده
مشکات	(قدیم)چراغدان،ازواژههایقرآنی،مکاننورانی–طاقیبلندکهچراغرادرآنگذارند
معینا	منسوببهمعین،یاریگر،کمککننده
ملودی	توالیتعدادیازاصواتدرموسیقی
ملیسا	زمانیبینمغربونمازعشا؛ماهصَفر؛ماهیبینآخرگرماوزمستان
ملیکا	اسمرومی،مادراماممهدی
ملیکه	زنصاحبومالکمنیبا
منیژه	خواهرفرنگیس،دخترافراسیاب
موژان	پرکرشمه،خمار،گلنرگشنیمشکفته
مونا	تک،یکتا،درمتونایرانباستانبهمُحبَّتهممعناشدهاست،گلیاس،امید
مهپیکر	آنکهپیکرشچونماهزیباودلانگیزاست
مهدخت	دختریکهمانندماهاست
مهسیما	ماهرو,ماهرخ،زیبا
مهنگار	معشوقهزیبارو
مهان	منسوببهماه
مهبان	نگهبانماه
مهتاب	نورآرامماه
مهتاج	زیبایزیبایان
مهدا	آرامششب
مهدخت	دختریکهمانندماهاست
مهدیا	دخترهدایتشده
مهررخسار	آنکهصورتشچونماهزیبااست
مهرنوش	زیبا،جاویدوهمیشگی
مهراسا	مانندخورشید
مهرافروز	افروزنده‌یمهربانی،مهربان
مهرافزا	آنکهمهرومحبتبیفزاید
مهرافزون	آنکهمهرومحبتبیفزاید
مهرافشان	مهربان
مهرانا	منسوببهمهران،دارندهمهر
مهرانگیز	برانگیزاننده‌یمحبتودوستی
مهرآگین	آکندهازمحبت
مهرآمیز	دوستانه،همدل
مهرآنا	(مهر=محبتودوستی،مهربانی+آنا(ترکی)=مادر)،
مهرآور	دوستیورزنده،ابرازمحبتکننده
مهربان	دارایمحبتوعاطفه
مهربانو	بانویمهربانوبامحبت
مهرچهر	آنکهچهره‌ایمهرباندارد
مهرچین	برگزینندهمهریانور
مهرخ	آنکهدارایرخساریچونماهاست
مهرگل	آنکهدرمیانگلهاچونخورشیدمیدرخشد
مهرناز	نامخواهرکیکاووسکهویرابههمسریرستمدادهبودند،خورشیدناز
مهرنگار	خورشیدزیباروی
مهروی	ماهرو،زیبارو
مهری	منسوببهمهر
مهسان	همانندماه
مهستی	ماهخانم
مهشید	مهتاب،روشناییماه
مهفام	بهرنگماه
مهکامه	بهمجازآرزویزیباروی
مهنا	گواراوخوش
مهناز	ماهناز
مهوش	مانندماه،خوشگل
مهین	بزرگ،بزرگتر
میترا	خورشید،مظهردوستیومحبتوروشنایی
میشکا	درگویشمازندرانیبهمعنایگنجشک
میگل	زیباروی
میگل	(می=شراب+گل)،(بهمجاز)زیباومستکننده
مینا	مرغمقلد،مرغمینا؛گلیمعمولاًسفید،نوعیشیشهرنگیبهویژهسبزکهازآنانواعظروفمیسازند.
مینو	جهانمعنوی،بهشت
مینوش	نوشندهمی،مینوشنده

نادیا	زنخوشآوتزبرگشتبهلیست
ناربن	درختانار
ناردانا	ناردانه،دانهانار
ناردانه	ناردانا،دانهانار
نارگل	گلانار،آنکهچونگللطیفوزیبااست.
نارگون	همانندانار،سرخوآتش
نارمیلا	(ترکی-فارسی)شکوفه،غنچه،خصوصاشکوفهگلانار
نارنج	میوه‌ایآبداروترش،ازگونهمرکبات
نارو	پرنده‌ایخوشآوازهمانندبلبل
نارون	درختیخوشانداموپُربَرگوسایهدار
نارین	منسوببهنار،تروتازه
نارینا	منسوببهآتش
ناز	دوستداشتنی،کرشمه،نامگلیاست
نازان	فخرکننده،نازکننده
نازآفرید	آفریدهنازوزیبا
نازآفرین	مرکبازناز(زیبا)+آفرین(آفریننده)،نامهمسرفتحعلیشاهقاجار
نازبانو	بانویزیباوعشوهگر
نازبو	ریحان
نازپر	آنکهمانندپریزیباست،نامدخترپادشاهخوارزم
نازپری	آنکهمانندپریزیباست،نامدخترپادشاهخوارزم
نازجهان	موجبنازشومباهاتجهان
نازخاتون	بانویزیبا،نامدخترامیرکردستاندرزمانپادشاهایالجایتو
نازدار	آنکهرفتاریخوشایندوجذابدارد،ملوس
نازدانه	فرزندمحبوبپدرومادر،دردانه
نازدخت	دخترزیباوناز
نازدلبر	معشوقزیباوجذاب،نامدختریدرمنظومهویسورامین
نازرخ	دارایرویزیباولطیف
نازک	نازنینوزیبا
نازلی	نازدار
نازمهر	زیباچونخورشید
نازنین	دارایناز،نازکاندام،دوستداشتنی
نازیاب	یابندهناز،‌ازشخصیت‌هایشاهنامه
نازیلا	بانازوکرشمه
نافه	مادهایباعطرخوشبووپایدار
ناکتا	ناک(درگویشمازندراننوعیگلابیشیرین)+تا،شیرینمثلگلابی
نانا	پدرومادر،نعناع
نانیسا	نامروستاییدرنزدیکیمراغه
ناوه	نامروستاییدرنزدیکیخرمآباد
ناهید	آناهیتا،پاکبانو
نایریکا	برگزیدهوپسندیده
نجلا	زنیکهدارایچشماندرشتاست.
نجوا	سخنآهسته
نخستین	آغازین،اولین
نرسا	دراساطیرزوروانیهنامیکیازخدایان
نرگس	نامگلیزیبا
نساک	نامهمسرسیامکپسرکیومرثپادشاهپیشدادی
نسترن	گلیشبیهرزبهرنگهایصورتی،سفیدوزرد
نسیم	بادبسیارآرامودلپذیر
نعیما	پرنعمت،برخوردار
نغمه	آهنگیاملودی
نکوزاد	زادهنیکویی
نکویار	یارنیکو
نکیسا	نامیکیازرامشگرانونوازندگانعهدخسروپرویز
نگار	چهرهزیبا
نگارا	بانویزیبا،دخترخوشچهره،کنایهازمحبوباست.
نگاره	نقش،شکل،تصویر
نگارین	زیبا،آراسته،مزین
نگین	جواهرانگشتری
نگینا	موسیقی،آواز
نگینه	مانندنگین
نوبهار	بهار،فصلرویش
نوا	صدایموسیقی،نغمه
نوال	عطا،بخشش،بهره،نصیب
نورا	نور(عربی)+ا(فارسی)،مؤنثانوردرخشان،تابان
نورسته	جوانهتازه
نوژان	درختصنوبروکاج
نوشاد	نامشهریکهزیبارویانآنمشهوربودند
نوشین	شیرین،خوشایند،دلپذیر،گوارا،خوشگوار
نوگل	گلیکهتازهشکفتهشدهاست
نونهال	نهالتازه،درختجوان
نها	عقلوخرد(اسمقرآنی)
نهال	درختیادرختچهنورس
نیایش	دعایهمراهباتضرعوزاری
نیروانا	آخرینمرحلهسلوکدرنزد“بودا”کهمرحلهمحوشدنجنبهحیوانیوجودورسیدنبهکمالاست.
نیکا	چهخوباست،خوشا،نامرودیدرشمالایران
نیکتا	خوب،نیکوریشه
نیکچهره	اوکهدارایچهره‌اینیکوست
نیکدخت	دخترنیکوشایسته
نیکرخ	نیکرو
نیکروی	خوشصورت
نیکناز	دارایعشوهگریوزیبایی
نیکو	خوب،زیبا
نیکی	خوببودن،خوبی،نیکوکاری،احسان
نیلا	نیلبهرنگنیل،نیلی
نیلاب	مجازاآبیملایموآرامشبخش.نامقدیمشهرجندیشاپور
نیلای	ماهنیلگون
نیلرام	اسمفرشتهنگهبانبرفوبارانوتگرگ
نیلگون	بهرنگنیل،کبود،لاجوردی
نیلوفر	نامگلیاست
نیلیا	بهزنگنیلی،منسوببهنیلی،مرکبازنیلیوالفنسبت
نینا	زیبایی،خوشاندامیوظرافت
نیوشا	شنونده،یادگیرنده

وَرد	گلسرخبرگشتبهلیست
وِستا	دانش،کتابمقدسزردشتیان
واپسین	آخرین،بازپسین
واج	زمزمه
واحده	مؤنثواحد،یگانه
وادی	سرزمین،رود
وارتوش	نامگلیسرخوظریف
وارسته	آزاد
واژه	کلمه،لغت
واله	عاشق،بیقرارشیفته
واله	عاشقبیقرار،شیفتهومفتون
والیه	مؤنثوالینامدختر
وانوش	دریاچهوان،ازسمبلونمادهایتاریخارامنه
وانوشه	نامگل
وانیا	هدیهباشکوهخداوند
وانیار	باسواد
وجیهه	زیبا،خوشچهره،همچنینبهمعنایدارایقدرومنزلتنزدمردم
وچان	زماناستراحتکوتاه
وحدانه	یکییکدانه
وحیده	مؤنثوحید،یکتا،تک،بینظیر،یگانه
ورتا	نامیپهلویبهمعنیگل
ورتاج	گلیسرخرنگکههمیشهرویبهآفتابدارد.
ورجا	بلندمرتبه،ارجمند
وردآفرید	آفریدهگل
وردآور	مرکبازورد(گل)+آور(آورنده)
وردی	کوچک،ریز‏نقش
ورشان	قمری،پرنده‌ایکهدرفارسیآنرامرغالاهیمی‌گویند،کبوترصحرایی
ورقا	کبوتر،نامدرختیکوچکومعروف
ورونیکا	نامتیرهایازگیاهانکهپوپکازآندستهاست.
ورهرام	بهرام،نامستارهمریخ،نامروزبیستمازهرماهشمسیدرایرانقدیم،
وریشه	درخشش،برق
وستا	پردانش–دخترپاکدامنوبااصلونسب
وسمه	مادهرنگیایکهازنوعیگیاهبهدستمی‌آید.
وسیم	داراینشانزیبایی،خوشسیما،زیبا
وسیمه	مؤنثوسیم،داراینشانزیبایی،زیبا
وش	خواستن
وشان	افشان،کاشتن،تکانشدید
وشن	خوباست.
وفا	وفاداری
ولان	مکانیکهگلزردبسیارداشتهباشد.
وناز	باوقار،متین
وندا	ستایشکننده
وندا	زنودخترباسواد
ونوس	سمبلزیباییوعشقدریونانباستان
ونوشه	درگویشمازندرانگلبنفشه
وهآفرید	(وه=خوب)آفریدهخوب
وهآفرین	آفرینندهخوبیاآفرینندهخوبی
وهنوش	بهنوش،مرکبازبه(بهتریاخوب)+نوش(عسل)
وهان	جمعخوبان،بهان(وه=خوب)
وهرو	خوبروی
وهشتیه	نامشهبانویخشایارشاه
وهوگون	خوشبو،معطر،خوشرنگ
ویان	دلربا،علاقه،محبت،عشق
ویانا	فرزانگی،بخردی،دانایی
ویدا	آشکاروهویدا
ویرا	ویشکا-ویدا–ویستا
ویرو	نامپهلوانوسپهداریدرمنظومهویسورامین
ویس	معشوقهرامیندردورهشاهنشاهیاشکانیان
ویستا	دانشوفرهنگ،برخوردار
ویشکا	نامروستایینزدیکرشت
ویکتوریا	پیروزشدن،الههپیروزیدررومباستان
وینا	رنگارنگ،همچنینروشنوآشکار
ویوگ	عروس
ویونا	منسوببهوَیو،(بهمجاز)عروس،دختریکهعروسشده،نامروستاییدرنزدیکیکاشان

هُووی	نامزناشوزرتشت,دخترفرشوشتربرگشتبهلیست
هاجر	معربازعبری؛بهمعنیمهاجرتکننده،فرارکننده.همچنیناسممادراسماعیلوهمسرحضرتابراهیم(ع)
هارا	کوهستان
هاله	معربازیونانیبهمعنایحلقهنورانیسفیدیارنگیکهگاهدورماهیاخورشیددیدهمی‌شود.
هانا	دادخواهی،امید،بینایی
هانه	چشمه
هانیا	مؤنثهانی،مادرمهربانودلسوز
هانیه	شادمانخوشبخت
هایده	توبهکننده،بهحقبازگردنده
هدا	هدی،هدایتکردن،هدایت،راهنمایی،راهدرستومسیردرست
هدسه	همسریهودیخشایارشاهکهبعداًاسترنامگرفت،محلدفناووداییش(مردخای)جزءآثارباستانیهمداناست.
هدی	هدایتشده
هدی	هدایتکردن،راهنمایی،هدایت،راهدرست،مسیردرست
هدیه	تحفهایکهبهنشانهمحبتبهکسیدادهمیشود
هدیه	ارمغان،تحفه
هرانوش	دخترآتش،دختریبارویبرافروخته،کنایهازدخترزیباروی
هستنوه	قیامتودهمردم
هستی	زندگی،وجود،زندگانی
هفدن	وزنشعر
هفیان	آرامگرفتن
هگبه	رهآورد،هدیهسفر،خورجین
هلاله	گلیزردرنگخوشبو،آلاله،جارزدن،باخبرساختن
هلپرین	رقصیدن
هلما	معنیاسمرادراینقسمتبنویسیدخیلیصبور
هلن	فرانسهازیونانیروشنایی،نور،دراساطیریونانهمسرمنلاسپادشاهاسپارتکهجنگتروابهخاطراورویداد.
هلناز	زیباوخوشبو
هلناز	زیبارووخوشبو،بهشکوفهدرختهلنیزمی‌گویند
هلنسا	زنانمعطر
هلیا	خورشید
هلیله	نامدرختیاست
هلینا	هلن،فرانسهازیونانیروشنایی،نور،دراساطیریونانهمسرمنلاسپادشاهاسپارتکهجنگتروابهخاطراورویداد.
هلیون	هلیوس،خورشید
هما	مرغخوشپروازومایهسلامت،ازشخصیت‌هایشاهنامه
هماچهر	آنکهچهره‌ایچونهمادارد،خوشسیما
همافر	دارایشکوههمایی
همایون	فرخ،شادان
همتا	همانند
همتا	نظیر،مانند
همدم	همنشین
همراز	محرماسرار
همساز	ازنامهایبرگزیده
همگام	همراه،همسفر
هموند	اعضاء
همیلا	نامیکیازندیمههایشیریندرخسرووشیریننظامی
همیلا	نامندیمهشیرینهمسرخسروپرویزپادشاهساسانی
هنا	شادمانیوخوشبختی
هنار	انار
هناو	زهره،شجاعت
هنگامه	فوقالعاده،شگفتانگیز،عالی،فتنه،آشوب
هنیا	بهفتحه،گواراباد،نوشباد
هوآفرید	خوشستوده،خوشآمرزیده
هوبخت	خوشبخت
هوپاد	(اسمدختروپسر)نگهبانخوب،نیکسرشت
هوتس	(بهضمت)آتوسا،نامدخترکوروشپادشاههخامنشی،همسرداریوشومادرخشایارشا
هوتوس	آتوسا،نامدخترکوروشپادشاههخامنشی،همسرداریوشومادرخشایارشا
هوداد	ازنامهایبرگزیده
هوده	راست،درست
هور	خور،خورشید،ازشخصیتهایشاهنامه،نامداناییپرهیزکاردرزمانبهرامگورپادشاهساسانی
هورام	پیروخوبی،انسانشادوخندهرو،هنگامطلوعآفتاب،‌مرتفع
هوران	آفتاب
هورآفرین	آفرینندهخورشید
هوربانو	زیباهمچونخورشید
هورتاش	هور(فارسی)+تاش(ترکی)آنکهچونخورشیدنورانیاست.
هورتن	آنکهتنوبدنیپاکودرخشانچونخورشیددارد.
هورچهر	آنکهچهرهوسیماییدرخشانونورانیچونخورشیددارد.
هورخش	آفتابعالمتاب
هورداد	داده‌یخورشید،تابندهوپرحرارت
هوردخت	دختریزیباچونخورشید
هوردیس	زیباوروشنچونخورشید
هوررخ	هورچهر
هورزاد	زادهخورشید،خوبزاده،اصیل،شریف
هورسان	مانندخورشید
هورشاد	مرکبازهور(خورشید)+شاد
هورشید	خورشید،آفتاب
هورفَر	دارایفروشکوهمانندخورشید
هورمهر	مهربانهمانندخورشید
هورناز	خورشیدزیبا
هوروَش	زیباوتابناکهمچونخورشید
هوروش	درخشانوزیباچونخورشید
هوری	نورخورشید
هوزاد	خوبزاده،اصیل
هوزان	نرگسنوشکفتهونیکدان
هوژان	یادگرفتن
هوژین	آموختن
هوشبام	سپیدهدم
هوفر	نامخواهریوئشتا
هوگون	خوبگون،خوشرنگ،ممتاز
هوما	مرغسعادت،فرخنده
هومان	خودمان
هومهر	دوست،یار
هوناز	ویژگیآن‌کهداراینازوکرشمهخوبونیکاست،جذابودلپسند
هونراوه	کنایهازکلاممنظوم
هونیا	داراینیایخوب
هووَرشت	نیکوکار
هویار	یارخوبوخوش
هیدیکا	آرام،بهآهستگی،یواش
هیران	قرار
هیزان	نیرومند،توانا
هیژان	ارزیدن،جنبیدن
هیلا	پرندهایکوچکترازباز
هیلا	پرنده‌ایشکاریکوچکترازبازراگویند.
هیلان	آشیانه،مکانآرامش
هیلدا	نیرومند،قوی
هیما	بانویعاشق
هیمو	پاکدامن
هینا	ماهر
هینان	آوردن
هیوان	ایوان،تراس

یَسنا	پرستش،ازبخش‌هایاوستابرگشتبهلیست
یارگل	دوستیکههمانندگلزیباست.
یارناز	دوستزیبا
یارنوش	دوستویاریکهچونعسلشیرینودلنشیناست.
یاس	گلیزینتیبارنگهایسفید،زرد،سرخوبنفشوبسیارخوشبو،گلمنسوببهحضرتزهرا(س)
یاسرخ	آنکهچهرهایچونگلیاسدارد
یاسگل	آنکهمانندگلیاسخوشچهرهوزیباست
یاسمن	گلیزینتیباگل‌هایدرشتومعطر،بهرنگهایسفید،صورتی،زردوقرمز
یاسمین	پهلوییاسمن–نوعیگل-دختریدرویسورامین
یاسمین	گلیاسمن
یاسمینا	یاسومیناگلیبهرنگهایسفید،زردوکبود
یاشیل	سبزکبود،سبزچمنی،کبود
یافا	زیبایی،جمال،نامشهریقدیمیدرساحلمدیترانه
یامین	لقبراحیل،همسرحضرتیعقوب(مادربنیامینویوسف)
یانا	نیکیرسان،نیکوییبخش
یرحا	ناممادرحضرتموسی(ع)
یسری	راحتی،آسانی،گشایش،دخترخوشقدم(یسرا)
یسنا	پرستش،بخشیازاوستا
یغما	غارت،تاراج،غنیمت،نامشهریدرترکستانکهمردمانزیبارویوصاحبجمالدارد.
یغماناز	ازترکیبیغما(ترکی)+ناز(فارسی)یغما،نامدخترپادشاهچینوهمسربهرامگورپادشاهساسانی
یکتا	یگانه،بینظیر،تنها
یکمال	ثروتتقسیمنشده،دوستجان‏جانی(بسیارصمیمی)
یکیتی	اتحاد،همبستگی
یگانه	صمیمی،همدل،یکرنگ،بیهمتا،بینظیر،تنهاومنحصربهفرد
یلدا	آخرینشبپائیزدرنیمکرهشمالیوبلندترینشبسالکههمزمانبامیلادمسیح(ع)است.
یلدوز	اولدوز،ستاره
یوتاب	نامخواهرآریوبرزنپادشاهآذربادگان
یوکابد	جلالخداوند،خداوندمجدوبزرگیاست،ناممادرموسی(ع)